Rk,Pos,90s,Tkl,TklW,Def 3rd,Mid 3rd,Att 3rd,Tkl,Att,Tkl%,Lost,Blocks,Sh,Pass,Int,Tkl+Int,Clr,Err,Rk,Pos,90s,CrdY,CrdR,2CrdY,Fls,Off,Crs,Int,TklW,PKcon,OG,Recov,Won,Lost,Won%
1,DF,13.7,29,19,20,7,2,20,34,58.8,14,9,5,4,8,37,27,0,1,DF,13.7,1,0,0,12,2,13,8,19,1,0,75,5,11,31.3
3,MF,1.1,2,2,1,1,0,1,1,100.0,0,2,0,2,0,2,0,0,3,MF,1.1,0,0,0,6,0,0,0,2,0,0,5,3,0,100.0
5,DF,30.9,64,35,36,23,5,26,45,57.8,19,51,32,19,39,103,109,2,5,DF,30.9,5,0,0,26,0,3,39,35,0,1,149,61,37,62.2
6,MF,16.9,21,14,8,10,3,8,18,44.4,10,12,1,11,12,33,18,0,6,MF,16.9,2,0,0,34,0,3,12,14,3,0,89,2,7,22.2
7,DF,2.0,0,0,0,0,0,0,1,0.0,1,0,0,0,0,0,4,0,7,DF,2.0,0,0,0,1,0,0,0,0,0,0,10,4,6,40.0
8,MF,31.8,85,52,43,34,8,38,96,39.6,58,29,6,23,61,146,61,3,8,MF,31.8,4,0,0,36,1,34,61,52,0,0,226,15,14,51.7
10,DF,15.6,25,19,15,9,1,17,34,50.0,17,23,5,18,15,40,62,0,10,DF,15.6,3,0,0,16,2,26,15,19,1,0,79,14,10,58.3
12,DF,25.7,35,19,28,5,2,21,35,60.0,14,31,26,5,23,58,115,0,12,DF,25.7,10,0,0,33,1,2,23,19,2,1,109,39,36,52.0
14,DF,26.5,22,13,16,6,0,11,14,78.6,3,20,13,7,32,54,77,1,14,DF,26.5,1,0,0,19,3,9,32,13,0,0,102,70,37,65.4
15,DF,0.1,0,0,0,0,0,0,0,,0,3,3,0,0,0,0,0,15,DF,0.1,0,0,0,0,0,0,0,0,0,0,1,0,1,0.0
16,DF,14.4,33,21,20,12,1,9,14,64.3,5,12,2,10,4,37,25,0,16,DF,14.4,7,0,0,18,1,82,4,21,0,0,99,13,11,54.2
18,MF,1.3,4,3,1,3,0,2,3,66.7,1,2,0,2,4,8,2,0,18,MF,1.3,0,0,0,0,0,1,4,3,0,0,7,2,3,40.0
21,DF,18.0,21,11,16,5,0,12,21,57.1,9,16,11,5,25,46,80,0,21,DF,18.0,2,0,0,10,0,1,25,11,0,0,43,56,28,66.7
25,DF,13.8,13,9,8,3,2,6,7,85.7,1,15,8,7,18,31,64,1,25,DF,13.8,2,0,0,10,2,2,18,9,0,0,60,30,22,57.7
27,MF,15.6,34,17,17,13,4,13,35,37.1,22,22,8,14,20,54,15,1,27,MF,15.6,3,0,0,26,1,50,20,17,1,0,94,15,10,60.0
30,MF,24.8,35,20,9,20,6,15,34,44.1,19,28,6,22,12,47,22,0,30,MF,24.8,8,0,0,37,0,12,12,20,0,0,135,11,16,40.7
31,DF,28.8,65,41,38,23,4,44,64,68.8,20,47,25,22,55,120,116,1,31,DF,28.8,1,0,0,31,2,6,55,41,3,0,217,45,32,58.4
33,MF,0.1,0,0,0,0,0,0,0,,0,0,0,0,0,0,0,0,33,MF,0.1,0,0,0,0,0,0,0,0,0,0,0,1,0,100.0
34,MF,8.6,23,18,7,14,2,9,12,75.0,3,6,1,5,7,30,8,0,34,MF,8.6,3,0,0,19,0,2,7,18,0,0,48,9,7,56.3
35,"DF,MF",17.9,45,29,28,13,4,29,41,70.7,12,27,7,20,13,58,41,0,35,"DF,MF",17.9,2,0,0,15,2,46,13,29,0,0,71,15,24,38.5
36,DF,20.6,26,14,19,7,0,16,22,72.7,6,33,24,9,17,43,85,2,36,DF,20.6,3,1,1,10,0,5,17,14,1,0,102,48,32,60.0
37,DF,21.4,53,31,27,23,3,27,45,60.0,18,35,5,30,26,79,46,0,37,DF,21.4,3,0,0,20,3,75,26,31,1,0,106,24,23,51.1
40,DF,29.4,64,36,48,14,2,30,49,61.2,19,43,26,17,34,98,137,2,40,DF,29.4,11,1,1,34,2,6,34,36,0,0,106,52,36,59.1
41,DF,4.5,8,3,6,2,0,4,8,50.0,4,3,1,2,4,12,28,0,41,DF,4.5,0,0,0,4,0,0,4,3,0,0,22,14,9,60.9
42,DF,18.8,47,31,31,12,4,29,40,72.5,11,19,3,16,18,65,51,1,42,DF,18.8,3,0,0,18,2,28,18,31,1,0,97,17,12,58.6
43,"DF,MF",25.9,71,44,41,23,7,28,49,57.1,21,32,6,26,15,86,38,0,43,"DF,MF",25.9,7,0,0,25,8,41,15,44,1,0,136,21,25,45.7
45,DF,20.4,38,21,25,9,4,23,36,63.9,13,26,11,15,25,63,79,1,45,DF,20.4,5,0,0,25,1,22,25,21,0,0,60,63,23,73.3
47,"DF,MF",27.9,42,28,16,18,8,22,39,56.4,17,28,12,16,23,65,70,3,47,"DF,MF",27.9,4,1,1,17,0,9,23,28,0,0,142,27,27,50.0
49,DF,22.7,26,16,15,8,3,13,20,65.0,7,17,2,15,14,40,54,0,49,DF,22.7,0,0,0,10,0,11,14,16,0,0,119,46,28,62.2
51,DF,18.6,27,15,18,7,2,13,16,81.3,3,14,4,10,10,37,34,0,51,DF,18.6,2,0,0,18,1,57,10,15,2,0,99,10,15,40.0
52,DF,9.1,11,5,6,3,2,8,11,72.7,3,9,3,6,10,21,25,0,52,DF,9.1,2,0,0,17,0,21,10,5,0,0,40,6,4,60.0
53,MF,0.2,0,0,0,0,0,0,1,0.0,1,0,0,0,0,0,0,0,53,MF,0.2,0,0,0,0,0,0,0,0,0,0,0,0,0,
55,MF,0.3,5,3,0,2,3,3,3,100.0,0,3,1,2,1,6,1,0,55,MF,0.3,0,0,0,1,0,0,1,3,0,0,0,0,0,
56,MF,3.4,14,9,2,10,2,6,7,85.7,1,5,1,4,6,20,11,0,56,MF,3.4,1,0,0,9,0,0,6,9,0,0,25,8,5,61.5
57,MF,7.8,20,11,14,4,2,3,9,33.3,6,10,4,6,12,32,15,1,57,MF,7.8,5,0,0,15,0,1,12,11,1,0,29,5,7,41.7
59,DF,12.2,35,18,22,12,1,26,35,74.3,9,28,8,20,18,53,32,0,59,DF,12.2,7,0,0,15,0,4,18,18,1,0,60,25,21,54.3
60,DF,12.8,13,9,7,5,1,4,8,50.0,4,10,7,3,15,28,34,0,60,DF,12.8,2,0,0,4,0,17,15,9,0,1,63,10,9,52.6
61,MF,25.7,35,20,16,12,7,15,53,28.3,38,34,4,30,7,42,13,0,61,MF,25.7,7,0,0,16,6,150,7,20,0,0,140,10,19,34.5
62,DF,22.6,25,14,15,9,1,18,27,66.7,9,31,24,7,16,41,102,0,62,DF,22.6,6,0,0,21,1,0,16,14,0,0,75,46,29,61.3
63,MF,0.1,0,0,0,0,0,0,0,,0,0,0,0,0,0,0,0,63,MF,0.1,0,0,0,0,0,0,0,0,0,0,0,0,0,
64,MF,4.2,6,6,0,6,0,5,10,50.0,5,5,2,3,5,11,4,0,64,MF,4.2,0,0,0,5,0,1,5,6,0,0,17,2,9,18.2
65,MF,34.8,97,59,39,52,6,50,121,41.3,71,60,14,46,33,130,55,2,65,MF,34.8,14,0,0,84,1,36,33,59,0,0,234,47,49,49.0
66,DF,24.4,28,21,15,13,0,19,35,54.3,16,30,18,12,13,41,111,0,66,DF,24.4,8,1,0,34,2,5,13,21,0,0,107,55,45,55.0
67,MF,18.8,40,23,23,11,6,17,57,29.8,40,20,0,20,7,47,17,0,67,MF,18.8,17,0,0,49,9,151,7,23,1,0,87,15,18,45.5
68,MF,11.3,24,8,7,14,3,10,24,41.7,14,14,3,11,4,28,13,0,68,MF,11.3,6,0,0,22,3,33,4,8,0,0,53,11,19,36.7
69,DF,23.9,39,26,26,11,2,27,87,31.0,60,22,2,20,31,70,48,5,69,DF,23.9,6,0,0,9,2,168,31,26,0,0,176,8,6,57.1
77,"MF,DF",20.7,30,18,11,14,5,14,35,40.0,21,20,3,17,13,43,30,0,77,"MF,DF",20.7,1,0,0,15,1,47,13,18,0,0,100,16,26,38.1
81,DF,2.8,5,3,2,3,0,3,4,75.0,1,2,0,2,4,9,6,0,81,DF,2.8,0,0,0,7,0,15,4,3,0,0,14,2,4,33.3
82,"DF,MF",8.6,16,7,9,6,1,9,24,37.5,15,18,5,13,5,21,18,0,82,"DF,MF",8.6,3,0,0,12,0,5,5,7,1,0,42,2,7,22.2
83,MF,6.3,15,8,8,6,1,11,23,47.8,12,12,1,11,9,24,10,0,83,MF,6.3,1,0,0,8,0,1,9,8,0,0,41,2,4,33.3
84,MF,26.4,80,39,47,26,7,31,66,47.0,35,59,20,39,42,122,81,0,84,MF,26.4,11,0,0,33,1,4,42,39,1,0,164,30,34,46.9
85,DF,28.2,68,37,43,20,5,37,57,64.9,20,40,11,29,35,103,80,0,85,DF,28.2,7,0,0,43,1,25,35,37,0,0,132,51,30,63.0
86,"MF,DF",8.5,14,9,8,3,3,9,20,45.0,11,4,1,3,5,19,9,0,86,"MF,DF",8.5,1,0,0,9,1,22,5,9,0,0,47,5,6,45.5
88,DF,12.8,18,9,15,3,0,12,19,63.2,7,8,5,3,11,29,34,1,88,DF,12.8,1,1,0,15,0,1,11,9,0,0,68,43,15,74.1
89,MF,4.7,8,7,5,2,1,2,9,22.2,7,5,1,4,2,10,5,0,89,MF,4.7,2,0,0,12,0,2,2,7,1,0,20,9,7,56.3
90,MF,1.4,6,4,1,5,0,3,3,100.0,0,3,1,2,1,7,1,0,90,MF,1.4,1,0,0,2,0,0,1,4,0,0,9,6,1,85.7
94,MF,0.2,0,0,0,0,0,0,0,,0,0,0,0,0,0,0,0,94,MF,0.2,0,0,0,1,0,0,0,0,0,0,3,1,1,50.0
95,DF,1.0,1,1,0,1,0,1,3,33.3,2,2,1,1,3,4,2,0,95,DF,1.0,1,0,0,2,0,1,3,1,0,0,7,1,0,100.0
97,DF,8.9,16,7,12,4,0,11,15,73.3,4,6,0,6,7,23,28,0,97,DF,8.9,2,0,0,13,0,14,7,7,0,0,19,6,4,60.0
98,DF,6.4,11,3,9,2,0,4,5,80.0,1,4,2,2,9,20,19,2,98,DF,6.4,2,0,0,10,0,1,9,3,0,0,39,19,10,65.5
99,DF,11.1,23,11,13,6,4,15,23,65.2,8,9,2,7,11,34,34,2,99,DF,11.1,3,0,0,10,6,16,11,11,0,0,60,15,11,57.7
100,MF,14.6,22,14,8,10,4,13,19,68.4,6,16,2,14,14,36,18,0,100,MF,14.6,5,0,0,11,1,126,14,14,0,0,93,10,5,66.7
101,MF,1.0,4,2,0,3,1,0,3,0.0,3,0,0,0,0,4,1,0,101,MF,1.0,0,0,0,1,0,1,0,2,0,0,8,0,0,
102,MF,0.0,0,0,0,0,0,0,0,,0,0,0,0,0,0,0,0,102,MF,0.0,0,0,0,0,0,0,0,0,0,0,0,0,0,
103,"MF,DF",10.4,27,16,17,8,2,17,31,54.8,14,20,7,13,8,35,19,2,103,"MF,DF",10.4,6,0,0,24,0,7,8,16,0,0,60,5,6,45.5
104,DF,37.9,56,35,33,21,2,29,39,74.4,10,33,18,15,41,97,207,1,104,DF,37.9,7,0,0,43,1,31,41,35,0,0,193,89,46,65.9
107,MF,28.6,89,49,39,45,5,43,81,53.1,38,34,5,29,35,124,60,0,107,MF,28.6,8,0,0,51,1,19,35,49,0,0,195,78,56,58.2
109,"MF,DF",18.8,30,18,8,14,8,13,24,54.2,11,15,4,11,20,50,17,0,109,"MF,DF",18.8,4,0,0,23,0,14,20,18,0,0,122,20,22,47.6
110,DF,17.3,20,12,14,6,0,14,21,66.7,7,31,18,13,28,48,74,2,110,DF,17.3,5,0,0,20,1,0,28,12,0,0,77,58,30,65.9
111,DF,12.7,21,11,12,6,3,11,19,57.9,8,11,5,6,12,33,37,1,111,DF,12.7,2,0,0,13,1,53,12,11,0,1,55,15,9,62.5
113,"DF,MF",1.8,1,1,1,0,0,1,3,33.3,2,0,0,0,4,5,8,0,113,"DF,MF",1.8,2,1,0,1,0,8,4,1,0,0,15,6,5,54.5
115,DF,32.1,39,25,21,16,2,23,42,54.8,19,33,20,13,40,79,150,1,115,DF,32.1,7,0,0,25,0,14,40,25,1,1,203,79,42,65.3
121,MF,3.8,6,2,3,2,1,1,6,16.7,5,1,0,1,2,8,7,0,121,MF,3.8,2,0,0,18,0,6,2,2,0,0,27,5,8,38.5
122,DF,6.0,24,15,12,10,2,15,25,60.0,10,8,3,5,7,31,17,0,122,DF,6.0,3,0,0,11,0,7,7,15,0,0,24,7,7,50.0
123,MF,0.1,0,0,0,0,0,0,0,,0,0,0,0,0,0,0,0,123,MF,0.1,0,0,0,0,0,0,0,0,0,0,0,0,0,
124,DF,16.2,41,22,29,7,5,23,33,69.7,10,23,16,7,10,51,52,1,124,DF,16.2,5,0,0,13,2,23,10,22,0,0,81,29,21,58.0
125,DF,22.2,27,22,11,15,1,12,17,70.6,5,20,11,9,12,39,66,2,125,DF,22.2,6,0,0,25,0,8,12,22,1,0,102,60,22,73.2
126,MF,10.5,23,14,11,8,4,7,15,46.7,8,17,7,10,16,39,9,0,126,MF,10.5,2,0,0,10,0,7,16,14,0,1,52,9,15,37.5
128,MF,0.1,0,0,0,0,0,0,0,,0,0,0,0,0,0,0,0,128,MF,0.1,1,0,0,1,0,0,0,0,0,0,1,0,0,
131,DF,29.6,45,24,25,13,7,31,38,81.6,7,36,15,21,18,63,58,0,131,DF,29.6,3,0,0,30,3,110,18,24,0,0,130,28,21,57.1
134,DF,0.2,1,0,0,1,0,0,0,,0,0,0,0,0,1,1,0,134,DF,0.2,0,0,0,1,0,0,0,0,0,0,1,1,0,100.0
135,"DF,MF",2.6,3,3,2,0,1,2,3,66.7,1,1,0,1,1,4,3,0,135,"DF,MF",2.6,1,0,0,1,0,14,1,3,0,0,6,2,3,40.0
139,MF,27.8,51,31,15,27,9,28,57,49.1,29,23,4,19,24,75,60,0,139,MF,27.8,9,0,0,37,0,110,24,31,0,0,174,14,30,31.8
143,DF,2.0,4,3,2,0,2,2,2,100.0,0,1,1,0,0,4,7,0,143,DF,2.0,0,0,0,2,0,7,0,3,0,0,10,2,3,40.0
146,MF,8.7,7,2,3,4,0,2,11,18.2,9,9,3,6,11,18,8,0,146,MF,8.7,1,0,0,4,0,35,11,2,0,0,57,4,7,36.4
150,DF,13.7,35,17,18,13,4,14,27,51.9,13,22,7,15,19,54,43,1,150,DF,13.7,5,1,1,33,1,29,19,17,2,0,67,13,17,43.3
151,DF,11.2,24,12,12,8,4,9,24,37.5,15,9,4,5,9,33,27,1,151,DF,11.2,4,0,0,22,1,22,9,12,0,0,67,11,17,39.3
152,DF,4.0,9,3,6,2,1,6,8,75.0,2,7,1,6,4,13,1,0,152,DF,4.0,2,0,0,3,0,6,4,3,0,0,28,2,2,50.0
153,MF,6.2,19,13,6,9,4,5,13,38.5,8,5,1,4,6,25,9,0,153,MF,6.2,0,0,0,19,0,5,6,13,0,0,28,8,12,40.0
158,DF,26.9,26,19,18,6,2,16,25,64.0,9,21,10,11,17,43,89,0,158,DF,26.9,5,0,0,15,1,153,17,19,0,0,147,34,28,54.8
159,DF,19.2,29,21,20,9,0,15,22,68.2,7,20,8,12,16,45,52,0,159,DF,19.2,1,0,0,17,1,40,16,21,0,0,74,59,26,69.4
160,DF,10.0,14,6,10,3,1,6,9,66.7,3,10,7,3,5,19,23,0,160,DF,10.0,0,0,0,6,2,5,5,6,0,0,37,18,17,51.4
161,"DF,MF",9.3,20,14,9,11,0,5,11,45.5,6,10,3,7,9,29,36,1,161,"DF,MF",9.3,2,0,0,8,0,22,9,14,0,0,50,30,20,60.0
167,MF,17.4,37,20,13,20,4,20,46,43.5,26,20,6,14,32,69,21,1,167,MF,17.4,1,0,0,21,1,7,32,20,0,0,94,15,16,48.4
169,DF,15.8,25,14,15,9,1,12,19,63.2,7,25,6,19,16,41,46,0,169,DF,15.8,4,0,0,29,0,11,16,14,0,0,72,21,23,47.7
170,"DF,MF",10.6,19,11,10,6,3,9,18,50.0,9,11,2,9,16,35,23,0,170,"DF,MF",10.6,1,0,0,5,4,48,16,11,0,0,59,13,11,54.2
171,MF,6.1,12,7,4,5,3,7,14,50.0,7,8,2,6,6,18,12,0,171,MF,6.1,4,0,0,14,1,2,6,7,0,0,37,5,11,31.3
172,MF,0.0,0,0,0,0,0,0,0,,0,1,0,1,0,0,0,0,172,MF,0.0,0,0,0,0,0,0,0,0,0,0,1,1,0,100.0
173,MF,15.9,46,26,27,18,1,17,39,43.6,22,20,6,14,11,57,27,2,173,MF,15.9,5,0,0,29,0,4,11,26,1,0,123,30,17,63.8
174,DF,1.0,2,2,0,2,0,1,1,100.0,0,1,1,0,0,2,2,0,174,DF,1.0,0,0,0,2,0,0,0,2,0,0,4,3,1,75.0
177,DF,25.3,65,41,53,12,0,30,49,61.2,19,23,15,8,38,103,116,2,177,DF,25.3,5,1,0,24,1,2,38,41,0,0,151,76,38,66.7
178,MF,28.2,51,27,23,24,4,24,61,39.3,37,45,13,32,50,101,54,1,178,MF,28.2,6,0,0,24,0,14,50,27,0,0,177,12,13,48.0
179,"DF,MF",20.0,51,25,32,11,8,33,65,50.8,32,22,4,18,25,76,20,0,179,"DF,MF",20.0,1,0,0,17,1,32,25,25,0,0,121,11,17,39.3
180,DF,14.9,21,15,12,9,0,9,14,64.3,5,21,14,7,18,39,66,2,180,DF,14.9,3,0,0,17,1,2,18,15,1,1,82,28,22,56.0
185,DF,9.3,5,3,4,1,0,2,2,100.0,0,8,8,0,9,14,38,2,185,DF,9.3,4,0,0,6,0,0,9,3,0,1,51,15,7,68.2
186,MF,0.3,4,1,3,1,0,3,5,60.0,2,0,0,0,0,4,0,0,186,MF,0.3,0,0,0,1,0,0,0,1,0,0,2,0,0,
189,MF,14.6,34,17,14,17,3,15,28,53.6,13,10,4,6,26,60,15,1,189,MF,14.6,5,0,0,25,2,1,26,17,0,0,94,24,17,58.5
190,DF,4.2,7,3,6,1,0,2,12,16.7,10,5,0,5,3,10,6,0,190,DF,4.2,1,0,0,4,1,13,3,3,0,0,30,4,1,80.0
191,"DF,MF",22.4,37,20,24,7,6,21,46,45.7,25,27,1,26,21,58,45,1,191,"DF,MF",22.4,4,0,0,24,3,54,21,20,0,0,124,21,27,43.8
195,DF,15.3,20,11,11,6,3,7,11,63.6,4,14,1,13,5,25,21,1,195,DF,15.3,1,0,0,9,4,37,5,11,0,0,67,12,13,48.0
196,DF,10.8,18,10,10,7,1,6,15,40.0,9,14,8,6,10,28,33,0,196,DF,10.8,4,0,0,19,1,18,10,10,0,0,44,13,13,50.0
197,MF,14.7,40,20,17,19,4,23,46,50.0,23,35,7,28,18,58,30,3,197,MF,14.7,7,0,0,40,0,0,18,20,0,0,95,24,9,72.7
198,MF,0.7,6,2,1,4,1,3,4,75.0,1,0,0,0,2,8,0,0,198,MF,0.7,0,0,0,2,0,0,2,2,0,0,2,0,0,
199,DF,25.2,79,50,55,23,1,49,67,73.1,18,38,15,23,51,130,91,0,199,DF,25.2,6,1,1,25,1,2,51,50,0,0,167,57,36,61.3
200,DF,31.9,44,31,20,24,0,22,39,56.4,17,27,11,16,29,73,66,1,200,DF,31.9,4,0,0,41,8,68,29,31,0,0,127,30,27,52.6
201,"DF,MF",0.8,4,2,1,3,0,1,2,50.0,1,1,0,1,3,7,2,0,201,"DF,MF",0.8,1,0,0,4,0,4,3,2,0,0,6,0,2,0.0
207,MF,5.0,6,5,1,4,1,3,7,42.9,4,3,0,3,3,9,9,0,207,MF,5.0,2,0,0,5,0,7,3,5,0,0,34,4,12,25.0
209,DF,25.6,26,10,18,7,1,11,22,50.0,11,51,31,20,22,48,116,1,209,DF,25.6,9,0,0,21,2,1,22,10,0,0,98,49,42,53.8
211,MF,2.5,4,4,2,2,0,1,5,20.0,4,5,1,4,3,7,6,0,211,MF,2.5,1,0,0,3,0,3,3,4,0,0,17,3,6,33.3
216,DF,29.5,69,38,28,30,11,37,63,58.7,26,46,12,34,42,111,46,0,216,DF,29.5,7,1,0,40,1,70,42,38,1,0,204,23,29,44.2
217,MF,31.6,46,30,17,20,9,19,63,30.2,44,31,1,30,10,56,12,1,217,MF,31.6,7,0,0,28,3,51,10,30,0,0,167,20,15,57.1
219,MF,29.1,47,19,16,21,10,11,48,22.9,37,25,9,16,25,72,51,2,219,MF,29.1,6,0,0,25,0,45,25,19,0,0,201,42,34,55.3
222,MF,29.0,65,40,19,37,9,30,50,60.0,20,45,16,29,36,101,53,0,222,MF,29.0,8,0,0,58,3,5,36,40,0,0,144,39,63,38.2
223,MF,31.2,65,42,28,29,8,28,70,40.0,42,47,12,35,27,92,61,2,223,MF,31.2,10,0,0,32,0,1,27,42,0,0,231,51,43,54.3
225,MF,17.3,45,25,15,29,1,19,40,47.5,21,20,3,17,28,73,24,2,225,MF,17.3,5,0,0,23,0,16,28,25,0,0,94,14,21,40.0
226,"DF,MF",0.9,2,0,1,1,0,2,4,50.0,2,1,1,0,0,2,7,0,226,"DF,MF",0.9,0,0,0,1,0,0,0,0,0,0,2,3,0,100.0
227,DF,2.5,4,3,3,1,0,4,5,80.0,1,3,1,2,3,7,10,0,227,DF,2.5,1,0,0,4,0,0,3,3,0,0,15,4,4,50.0
228,DF,36.6,21,12,16,5,0,8,15,53.3,7,42,26,16,23,44,144,1,228,DF,36.6,3,1,0,30,0,3,23,12,2,0,153,93,70,57.1
229,DF,0.1,2,1,1,1,0,1,1,100.0,0,0,0,0,0,2,1,0,229,DF,0.1,0,0,0,0,0,0,0,1,0,0,2,0,2,0.0
230,"DF,MF",3.6,7,2,4,3,0,2,9,22.2,7,9,4,5,5,12,17,0,230,"DF,MF",3.6,1,0,0,3,2,4,5,2,0,0,16,7,8,46.7
231,MF,12.9,20,13,10,9,1,10,27,37.0,17,18,6,12,14,34,29,0,231,MF,12.9,5,0,0,14,0,25,14,13,0,0,60,8,12,40.0
232,DF,25.6,49,29,33,15,1,21,29,72.4,8,32,11,21,28,77,84,4,232,DF,25.6,6,1,1,15,2,3,28,29,1,0,171,30,25,54.5
233,DF,25.2,46,33,31,12,3,26,40,65.0,14,25,11,14,23,69,48,1,233,DF,25.2,5,0,0,31,0,76,23,33,0,0,119,37,29,56.1
234,"MF,DF",8.3,22,13,12,7,3,11,22,50.0,11,8,0,8,11,33,18,0,234,"MF,DF",8.3,3,0,0,17,0,36,11,13,0,0,37,8,11,42.1
237,DF,9.0,19,12,13,4,2,9,17,52.9,8,14,8,6,11,30,30,1,237,DF,9.0,3,0,0,13,0,1,11,12,0,0,27,17,17,50.0
238,"DF,MF",0.3,1,0,0,0,1,0,0,,0,3,2,1,0,1,1,0,238,"DF,MF",0.3,0,0,0,1,0,0,0,0,0,0,0,0,0,
245,DF,0.1,2,1,1,1,0,0,0,,0,0,0,0,0,2,1,0,245,DF,0.1,0,0,0,0,0,0,0,1,0,0,0,0,0,
249,DF,0.0,0,0,0,0,0,0,0,,0,1,0,1,0,0,0,0,249,DF,0.0,0,0,0,0,0,0,0,0,0,0,0,0,0,
256,MF,1.0,1,1,0,1,0,1,1,100.0,0,0,0,0,1,2,0,0,256,MF,1.0,0,0,0,1,0,0,1,1,0,0,5,0,0,
257,MF,0.3,1,0,0,1,0,1,1,100.0,0,0,0,0,0,1,0,0,257,MF,0.3,0,0,0,0,0,0,0,0,0,0,5,0,0,
258,DF,19.1,50,33,30,19,1,22,35,62.9,13,33,15,18,25,75,60,1,258,DF,19.1,0,0,0,22,0,13,25,33,0,0,98,20,22,47.6
259,DF,7.4,8,8,7,1,0,4,8,50.0,4,7,5,2,6,14,30,0,259,DF,7.4,3,0,0,10,1,1,6,8,0,0,38,24,23,51.1
261,DF,33.8,36,26,15,17,4,18,31,58.1,13,21,4,17,15,51,36,3,261,DF,33.8,5,0,0,14,2,178,15,26,0,0,127,30,32,48.4
264,DF,19.0,34,22,14,16,4,20,53,37.7,33,13,5,8,22,56,40,1,264,DF,19.0,0,1,0,21,1,40,22,22,0,1,86,16,33,32.7
265,MF,25.7,42,34,14,18,10,12,36,33.3,24,55,5,50,21,63,17,0,265,MF,25.7,5,1,0,32,4,21,21,34,0,0,118,24,25,49.0
266,DF,16.1,32,22,23,8,1,22,28,78.6,6,18,10,8,13,45,49,0,266,DF,16.1,0,0,0,12,0,13,13,22,0,0,69,10,10,50.0
269,MF,27.0,56,32,22,23,11,24,63,38.1,39,28,2,26,18,74,34,0,269,MF,27.0,2,0,0,28,2,19,18,32,2,0,160,13,33,28.3
272,MF,4.7,11,6,5,2,4,4,10,40.0,6,7,1,6,5,16,7,0,272,MF,4.7,2,0,0,7,2,0,5,6,0,1,35,7,18,28.0
274,MF,12.6,56,35,19,26,11,19,34,55.9,15,13,5,8,19,75,31,0,274,MF,12.6,5,0,0,38,1,4,19,35,2,0,72,35,30,53.8
275,MF,12.8,29,19,11,16,2,11,22,50.0,11,12,4,8,12,41,9,2,275,MF,12.8,2,0,0,18,1,32,12,19,0,0,78,13,19,40.6
278,DF,11.5,34,21,21,11,2,24,34,70.6,10,22,7,15,16,50,37,0,278,DF,11.5,4,1,1,15,0,21,16,21,0,1,84,18,13,58.1
279,MF,21.9,49,32,29,18,2,22,43,51.2,21,33,12,21,37,86,33,0,279,MF,21.9,7,0,0,23,0,6,37,32,1,0,142,24,13,64.9
280,MF,11.2,23,15,10,11,2,10,24,41.7,14,15,4,11,17,40,16,1,280,MF,11.2,7,0,0,20,0,9,17,15,0,0,54,14,22,38.9
282,DF,11.2,22,14,14,8,0,10,25,40.0,15,15,6,9,20,42,25,0,282,DF,11.2,4,1,0,12,0,2,20,14,0,0,63,15,15,50.0
284,DF,21.4,33,25,13,14,6,19,33,57.6,14,28,9,19,20,53,62,0,284,DF,21.4,5,0,0,29,0,44,20,25,1,1,119,33,20,62.3
286,DF,19.6,41,25,25,13,3,24,40,60.0,16,22,10,12,21,62,52,0,286,DF,19.6,3,0,0,23,0,16,21,25,0,0,81,23,16,59.0
288,MF,33.4,76,46,35,36,5,34,58,58.6,24,49,20,29,23,99,60,2,288,MF,33.4,10,1,1,40,2,12,23,46,0,0,202,64,48,57.1
293,DF,32.5,99,58,56,35,8,45,69,65.2,24,66,30,36,55,154,120,1,293,DF,32.5,9,0,0,54,2,30,55,58,2,0,197,145,81,64.2
294,DF,25.6,52,34,23,22,7,20,35,57.1,15,35,8,27,12,64,45,1,294,DF,25.6,4,0,0,29,1,35,12,34,1,0,88,24,19,55.8
296,"MF,DF",3.6,7,2,2,4,1,2,3,66.7,1,6,1,5,0,7,3,0,296,"MF,DF",3.6,1,0,0,6,0,8,0,2,0,0,8,7,7,50.0
301,MF,0.0,0,0,0,0,0,0,0,,0,0,0,0,0,0,0,0,301,MF,0.0,0,0,0,0,0,0,0,0,0,0,0,0,0,
302,DF,28.3,27,11,14,11,2,16,25,64.0,9,35,21,14,15,42,99,2,302,DF,28.3,6,1,1,27,1,2,15,11,2,0,144,46,36,56.1
303,DF,13.7,35,20,22,12,1,14,24,58.3,10,22,15,7,16,51,68,1,303,DF,13.7,6,0,0,11,0,0,16,20,0,0,57,28,26,51.9
305,DF,23.2,43,27,34,9,0,22,35,62.9,13,36,21,15,23,66,140,1,305,DF,23.2,4,0,0,28,0,1,23,27,0,0,85,84,26,76.4
307,MF,15.5,33,16,7,22,4,9,27,33.3,18,31,5,26,20,53,28,1,307,MF,15.5,3,1,0,19,0,29,20,16,0,0,76,36,24,60.0
308,DF,26.2,47,28,20,24,3,28,52,53.8,24,30,5,25,14,61,43,0,308,DF,26.2,8,0,0,44,1,226,14,28,0,0,98,8,12,40.0
309,DF,1.0,3,3,1,2,0,1,3,33.3,2,0,0,0,2,5,5,0,309,DF,1.0,0,0,0,0,0,0,2,3,0,0,4,1,0,100.0
310,DF,22.4,28,19,16,7,5,14,25,56.0,11,30,11,19,18,46,48,0,310,DF,22.4,7,0,0,30,1,54,18,19,0,0,77,8,6,57.1
312,MF,23.0,80,52,32,36,12,41,61,67.2,20,28,5,23,37,117,43,3,312,MF,23.0,10,2,1,35,0,1,37,52,0,0,128,14,15,48.3
313,MF,17.5,42,18,20,17,5,15,39,38.5,24,18,1,17,13,55,6,0,313,MF,17.5,9,0,0,34,2,40,13,18,0,0,110,6,16,27.3
315,MF,27.0,61,36,29,27,5,31,86,36.0,55,25,2,23,35,96,30,0,315,MF,27.0,5,1,0,36,0,15,35,36,0,0,160,21,18,53.8
317,DF,0.5,1,0,1,0,0,1,1,100.0,0,1,0,1,0,1,4,0,317,DF,0.5,0,0,0,0,0,0,0,0,0,0,0,2,2,50.0
320,MF,18.2,33,19,11,19,3,15,43,34.9,28,16,2,14,22,55,39,0,320,MF,18.2,4,0,0,25,0,11,22,19,1,0,111,28,48,36.8
321,DF,33.0,47,21,33,13,1,29,47,61.7,18,37,19,18,21,68,113,0,321,DF,33.0,6,0,0,19,0,17,21,21,1,0,147,39,32,54.9
324,DF,2.6,0,0,0,0,0,0,0,,0,6,5,1,4,4,21,0,324,DF,2.6,0,0,0,2,1,1,4,0,0,0,10,8,7,53.3
326,DF,1.2,2,0,2,0,0,1,2,50.0,1,1,0,1,1,3,2,0,326,DF,1.2,1,0,0,6,0,0,1,0,0,0,6,1,2,33.3
328,DF,31.0,66,36,43,21,2,35,70,50.0,35,42,11,31,32,98,97,0,328,DF,31.0,9,0,0,38,4,40,32,36,0,1,139,50,29,63.3
329,MF,0.6,1,1,0,1,0,0,0,,0,1,0,1,0,1,3,0,329,MF,0.6,0,0,0,0,0,2,0,1,0,0,11,2,1,66.7
330,MF,5.9,8,6,5,3,0,2,10,20.0,8,8,2,6,14,22,6,1,330,MF,5.9,1,0,0,5,0,2,14,6,0,0,42,11,10,52.4
332,MF,22.5,48,33,18,25,5,27,46,58.7,19,23,13,10,14,62,33,2,332,MF,22.5,6,1,0,25,0,8,14,33,1,0,155,24,20,54.5
333,DF,16.0,46,29,36,9,1,22,40,55.0,18,32,21,11,25,71,90,0,333,DF,16.0,3,1,1,20,1,1,25,29,0,0,86,57,26,68.7
334,MF,25.3,26,13,6,10,10,9,21,42.9,12,16,1,15,14,40,10,0,334,MF,25.3,6,0,0,20,1,54,14,13,0,0,120,14,17,45.2
336,MF,16.4,29,22,16,10,3,13,17,76.5,4,13,3,10,6,35,13,0,336,MF,16.4,9,0,0,31,0,2,6,22,1,0,70,10,7,58.8
337,DF,1.0,4,2,2,2,0,2,3,66.7,1,1,1,0,1,5,1,0,337,DF,1.0,0,0,0,2,0,2,1,2,0,0,7,1,2,33.3
339,DF,1.0,4,0,0,4,0,1,2,50.0,1,0,0,0,0,4,7,1,339,DF,1.0,0,0,0,1,0,0,0,0,0,0,8,0,0,
340,DF,3.4,5,3,2,3,0,2,3,66.7,1,1,0,1,3,8,9,0,340,DF,3.4,0,0,0,4,0,0,3,3,0,0,15,6,7,46.2
341,DF,5.1,6,5,2,4,0,4,4,100.0,0,5,3,2,7,13,16,0,341,DF,5.1,0,0,0,2,0,6,7,5,1,0,32,5,7,41.7
342,DF,28.0,48,24,25,18,5,28,63,44.4,35,28,6,22,57,105,84,0,342,DF,28.0,3,1,0,21,8,79,57,24,0,0,156,37,45,45.1
344,DF,15.9,26,12,19,7,0,13,19,68.4,6,21,12,9,18,44,81,0,344,DF,15.9,5,0,0,27,1,1,18,12,0,2,66,29,24,54.7
347,DF,0.3,1,1,1,0,0,0,0,,0,0,0,0,0,1,1,0,347,DF,0.3,0,0,0,0,0,0,0,1,0,1,2,0,1,0.0
349,DF,15.3,20,13,14,6,0,8,13,61.5,5,20,16,4,9,29,61,3,349,DF,15.3,2,0,0,9,1,0,9,13,1,1,70,34,17,66.7
350,MF,0.5,2,2,0,2,0,1,2,50.0,1,1,0,1,0,2,0,0,350,MF,0.5,0,0,0,1,1,0,0,2,0,0,0,0,0,
351,MF,1.5,6,2,6,0,0,2,5,40.0,3,2,0,2,1,7,3,0,351,MF,1.5,3,1,1,8,0,2,1,2,0,0,17,1,2,33.3
353,MF,4.9,4,2,1,1,2,2,4,50.0,2,3,0,3,2,6,3,0,353,MF,4.9,0,0,0,1,0,10,2,2,0,0,18,0,3,0.0
355,MF,17.9,41,19,16,22,3,21,30,70.0,9,15,1,14,11,52,15,0,355,MF,17.9,5,0,0,25,1,23,11,19,0,0,88,22,27,44.9
357,MF,2.2,5,4,1,4,0,2,4,50.0,2,3,0,3,0,5,4,0,357,MF,2.2,1,0,0,5,1,2,0,4,2,0,19,2,3,40.0
361,MF,19.8,60,31,16,31,13,27,46,58.7,19,21,1,20,11,71,11,1,361,MF,19.8,2,0,0,31,1,8,11,31,0,0,95,29,35,45.3
364,DF,30.5,29,20,13,10,6,15,25,60.0,10,22,7,15,32,61,62,1,364,DF,30.5,5,0,0,14,0,81,32,20,0,0,150,23,28,45.1
365,DF,8.4,33,25,14,12,7,24,38,63.2,14,17,1,16,10,43,14,0,365,DF,8.4,2,0,0,8,2,18,10,25,0,1,50,11,5,68.8
369,DF,34.6,66,32,42,22,2,45,62,72.6,17,51,36,15,50,116,163,2,369,DF,34.6,8,0,0,25,5,1,50,32,1,0,181,94,43,68.6
370,MF,0.5,1,0,1,0,0,1,1,100.0,0,1,0,1,0,1,0,0,370,MF,0.5,0,0,0,1,0,1,0,0,0,0,0,1,1,50.0
371,DF,29.7,31,18,18,13,0,12,24,50.0,12,28,21,7,41,72,93,0,371,DF,29.7,11,1,1,34,1,5,41,18,1,0,180,55,35,61.1
372,DF,0.3,1,0,1,0,0,1,1,100.0,0,0,0,0,0,1,2,0,372,DF,0.3,0,0,0,0,0,1,0,0,0,0,0,0,0,
375,MF,7.0,20,11,11,9,0,13,21,61.9,8,15,3,12,8,28,10,0,375,MF,7.0,3,0,0,12,0,2,8,11,0,0,48,11,7,61.1
377,DF,35.9,58,42,32,21,5,21,29,72.4,8,45,27,18,40,98,147,0,377,DF,35.9,9,0,0,60,2,1,40,42,1,0,196,102,56,64.6
381,MF,25.8,28,13,13,12,3,9,25,36.0,16,22,5,17,10,38,37,0,381,MF,25.8,1,0,0,35,5,20,10,13,0,0,107,20,30,40.0
387,"DF,MF",0.6,0,0,0,0,0,0,1,0.0,1,2,0,2,0,0,4,0,387,"DF,MF",0.6,0,0,0,0,0,0,0,0,0,0,0,4,4,50.0
388,"MF,DF",10.4,22,13,7,11,4,9,21,42.9,12,13,1,12,14,36,20,0,388,"MF,DF",10.4,1,0,0,11,0,8,14,13,0,0,45,11,14,44.0
390,DF,17.1,28,15,17,10,1,15,30,50.0,15,29,17,12,27,55,109,1,390,DF,17.1,6,1,0,16,1,3,27,15,0,0,95,45,21,68.2
393,MF,25.0,61,35,23,28,10,27,37,73.0,10,33,8,25,34,95,40,1,393,MF,25.0,4,1,0,38,2,57,34,35,1,0,124,34,33,50.7
396,DF,1.8,1,1,0,0,1,1,2,50.0,1,1,0,1,0,1,4,0,396,DF,1.8,0,0,0,1,1,11,0,1,0,0,6,0,3,0.0
398,"DF,MF",8.2,21,14,12,7,2,12,19,63.2,7,17,4,13,6,27,24,0,398,"DF,MF",8.2,1,0,0,7,1,29,6,14,0,1,37,9,12,42.9
399,MF,1.3,4,2,4,0,0,3,3,100.0,0,3,0,3,0,4,1,0,399,MF,1.3,1,0,0,1,0,0,0,2,0,0,6,0,1,0.0
400,DF,9.1,13,7,5,7,1,5,11,45.5,6,22,12,10,6,19,33,0,400,DF,9.1,1,0,0,10,0,2,6,7,0,0,30,15,26,36.6
403,DF,28.1,70,39,43,24,3,24,34,70.6,10,20,12,8,69,139,131,0,403,DF,28.1,7,0,0,69,1,3,69,39,1,0,127,78,53,59.5
406,DF,18.4,37,23,17,14,6,12,26,46.2,14,25,18,7,18,55,78,1,406,DF,18.4,5,0,0,20,1,13,18,23,1,0,62,46,32,59.0
407,DF,30.3,61,33,37,20,4,26,61,42.6,35,55,25,30,37,98,124,1,407,DF,30.3,4,0,0,32,4,11,37,33,1,0,124,101,47,68.2
410,DF,6.6,11,9,6,3,2,7,12,58.3,5,9,2,7,10,21,12,0,410,DF,6.6,1,0,0,9,0,26,10,9,0,0,33,8,15,34.8
412,DF,0.5,1,1,0,0,1,1,1,100.0,0,0,0,0,1,2,3,0,412,DF,0.5,0,0,0,0,0,1,1,1,0,0,1,0,0,
413,"DF,MF",19.4,40,25,19,16,5,21,38,55.3,17,24,5,19,15,55,36,0,413,"DF,MF",19.4,5,0,0,23,1,46,15,25,0,0,94,29,20,59.2
417,DF,21.2,40,24,24,13,3,24,38,63.2,14,23,6,17,19,59,56,0,417,DF,21.2,6,0,0,30,1,68,19,24,0,0,119,17,22,43.6
418,DF,27.6,56,23,30,25,1,27,44,61.4,17,43,7,36,32,88,45,0,418,DF,27.6,8,0,0,34,0,73,32,23,1,0,173,29,29,50.0
419,MF,31.8,91,46,38,42,11,36,60,60.0,24,59,25,34,37,128,44,4,419,MF,31.8,11,0,0,50,0,10,37,46,1,0,200,30,31,49.2
420,MF,16.5,24,16,10,12,2,13,25,52.0,12,16,4,12,13,37,6,0,420,MF,16.5,3,0,0,16,0,25,13,16,0,1,105,14,6,70.0
421,MF,11.3,36,24,13,17,6,20,37,54.1,17,20,3,17,4,40,15,0,421,MF,11.3,7,0,0,29,1,6,4,24,1,0,46,15,17,46.9
422,DF,24.3,70,38,38,25,7,44,72,61.1,28,26,7,19,24,94,49,1,422,DF,24.3,5,2,1,25,0,36,24,38,1,0,90,12,27,30.8
423,DF,26.1,47,32,28,16,3,22,32,68.8,10,38,13,25,50,97,74,3,423,DF,26.1,4,0,0,35,2,9,50,32,2,1,194,60,24,71.4
424,DF,0.4,1,1,1,0,0,1,1,100.0,0,1,1,0,1,2,1,0,424,DF,0.4,0,0,0,0,0,0,1,1,0,0,3,2,0,100.0
425,DF,23.8,25,14,19,4,2,13,22,59.1,9,26,17,9,29,54,53,0,425,DF,23.8,7,1,1,24,1,4,29,14,1,0,58,30,23,56.6
426,DF,22.1,26,11,19,6,1,18,22,81.8,4,27,14,13,18,44,94,1,426,DF,22.1,2,1,0,16,0,0,18,11,0,0,86,57,15,79.2
427,MF,28.4,66,33,29,29,8,32,49,65.3,17,29,13,16,24,90,22,0,427,MF,28.4,5,0,0,43,0,153,24,33,0,0,166,26,18,59.1
430,MF,25.1,62,42,26,30,6,24,49,49.0,25,35,2,33,28,90,34,0,430,MF,25.1,3,0,0,45,1,119,28,42,0,0,180,11,26,29.7
431,MF,22.4,55,39,8,40,7,20,49,40.8,29,24,1,23,27,82,19,0,431,MF,22.4,7,0,0,37,3,45,27,39,0,0,77,32,30,51.6
432,MF,11.5,35,21,10,20,5,15,29,51.7,14,8,2,6,11,46,7,0,432,MF,11.5,4,0,0,25,0,1,11,21,0,0,85,7,8,46.7
434,"MF,DF",20.2,76,47,39,29,8,23,39,59.0,16,36,8,28,29,105,29,1,434,"MF,DF",20.2,9,0,0,49,1,4,29,47,1,0,146,18,17,51.4
439,MF,1.9,2,2,1,1,0,0,2,0.0,2,3,2,1,2,4,3,0,439,MF,1.9,0,0,0,0,0,4,2,2,0,0,16,2,0,100.0
440,"MF,DF",21.7,63,45,37,23,3,28,48,58.3,20,30,7,23,22,85,41,2,440,"MF,DF",21.7,5,0,0,27,0,2,22,45,0,0,156,29,21,58.0
442,DF,27.8,64,44,35,21,8,38,58,65.5,20,35,6,29,29,93,59,1,442,DF,27.8,7,0,0,40,4,82,29,44,0,0,165,24,23,51.1
443,DF,20.5,40,19,31,9,0,20,35,57.1,15,41,28,13,20,60,107,1,443,DF,20.5,4,0,0,14,0,8,20,19,2,0,93,30,22,57.7
448,MF,0.1,0,0,0,0,0,0,1,0.0,1,0,0,0,0,0,0,0,448,MF,0.1,0,0,0,0,0,1,0,0,0,0,2,0,0,
449,MF,16.2,32,18,17,12,3,15,22,68.2,7,20,4,16,22,54,24,1,449,MF,16.2,8,0,0,25,2,7,22,18,0,0,97,21,19,52.5
453,MF,33.6,91,64,39,37,15,38,107,35.5,69,40,9,31,48,139,26,2,453,MF,33.6,1,0,0,34,1,86,48,64,1,0,236,9,12,42.9
454,DF,16.5,38,22,24,12,2,20,31,64.5,11,23,13,10,17,55,56,1,454,DF,16.5,1,0,0,12,1,21,17,22,0,0,56,21,17,55.3
456,DF,29.0,50,31,30,15,5,25,45,55.6,20,24,7,17,27,77,87,2,456,DF,29.0,2,0,0,16,5,67,27,31,0,0,129,22,36,37.9
458,"MF,DF",0.6,1,1,0,0,1,1,3,33.3,2,1,0,1,0,1,1,0,458,"MF,DF",0.6,1,0,0,1,0,6,0,1,0,0,1,1,2,33.3
460,DF,31.3,90,55,52,29,9,55,96,57.3,41,45,7,38,46,136,102,0,460,DF,31.3,11,0,0,52,5,89,46,55,0,0,188,52,37,58.4
461,MF,14.8,48,29,19,24,5,22,33,66.7,11,20,5,15,32,80,31,0,461,MF,14.8,3,0,0,21,0,3,32,29,0,0,91,38,25,60.3
462,"DF,MF",2.9,8,6,6,1,1,4,6,66.7,2,0,0,0,3,11,6,0,462,"DF,MF",2.9,2,0,0,7,0,10,3,6,2,0,18,4,5,44.4
463,DF,20.2,27,16,22,4,1,13,21,61.9,8,24,19,5,13,40,78,3,463,DF,20.2,4,0,0,26,1,1,13,16,0,0,78,21,26,44.7
464,"DF,MF",14.6,30,21,13,14,3,9,28,32.1,19,15,2,13,21,51,25,0,464,"DF,MF",14.6,8,0,0,33,3,29,21,21,0,0,71,18,20,47.4
466,DF,2.5,4,4,3,1,0,2,7,28.6,5,2,0,2,1,5,6,0,466,DF,2.5,0,0,0,2,1,8,1,4,0,0,15,0,1,0.0
469,DF,0.1,0,0,0,0,0,0,0,,0,1,0,1,0,0,0,0,469,DF,0.1,0,0,0,0,0,0,0,0,0,0,1,0,0,
470,DF,24.1,47,32,28,15,4,23,42,54.8,19,28,9,19,22,69,54,4,470,DF,24.1,5,1,1,23,2,49,22,32,0,0,120,21,19,52.5
471,MF,1.8,3,1,0,2,1,1,3,33.3,2,8,0,8,0,3,1,0,471,MF,1.8,0,0,0,0,0,6,0,1,0,0,12,2,3,40.0
472,MF,7.6,20,12,11,7,2,10,16,62.5,6,8,1,7,8,28,9,1,472,MF,7.6,2,0,0,13,0,4,8,12,0,0,47,8,3,72.7
474,MF,0.2,1,1,1,0,0,1,1,100.0,0,0,0,0,1,2,2,0,474,MF,0.2,0,0,0,0,0,0,1,1,0,0,2,0,0,
475,DF,17.3,15,9,13,2,0,6,15,40.0,9,19,16,3,12,27,61,0,475,DF,17.3,5,0,0,24,0,0,12,9,1,0,74,23,24,48.9
476,"MF,DF",22.0,83,56,43,32,8,51,106,48.1,55,74,33,41,18,101,71,1,476,"MF,DF",22.0,7,0,0,30,6,13,18,56,1,0,133,42,22,65.6
477,DF,0.0,0,0,0,0,0,0,0,,0,0,0,0,0,0,1,0,477,DF,0.0,0,0,0,0,0,0,0,0,0,0,0,1,0,100.0
478,DF,23.8,54,31,24,24,6,29,59,49.2,30,35,14,21,18,72,59,0,478,DF,23.8,8,0,0,30,0,39,18,31,1,1,110,15,21,41.7
481,MF,21.6,70,34,31,33,6,29,61,47.5,32,34,4,30,27,97,33,1,481,MF,21.6,1,0,0,42,0,22,27,34,1,0,136,15,26,36.6
482,DF,29.3,49,24,23,16,10,26,44,59.1,18,38,10,28,38,87,69,1,482,DF,29.3,3,0,0,22,3,50,38,24,0,0,119,35,32,52.2
485,DF,27.4,34,26,22,10,2,18,29,62.1,11,19,10,9,32,66,81,0,485,DF,27.4,5,0,0,33,2,20,32,26,2,0,138,51,32,61.4
487,MF,0.1,0,0,0,0,0,0,1,0.0,1,1,1,0,0,0,0,0,487,MF,0.1,0,0,0,0,0,0,0,0,0,0,0,0,0,
490,MF,15.1,24,12,7,16,1,8,18,44.4,10,15,7,8,17,41,19,1,490,MF,15.1,8,0,0,17,0,31,17,12,0,0,105,6,4,60.0
491,DF,28.2,33,18,26,6,1,19,35,54.3,16,24,15,9,15,48,119,3,491,DF,28.2,8,1,0,47,1,0,15,18,1,0,129,59,30,66.3
492,DF,18.4,38,28,31,5,2,19,29,65.5,10,18,12,6,18,56,69,2,492,DF,18.4,6,3,1,39,0,4,18,28,1,0,72,19,17,52.8
496,DF,7.5,23,16,10,10,3,14,25,56.0,11,12,5,7,8,31,25,0,496,DF,7.5,1,0,0,14,0,20,8,16,0,0,33,3,7,30.0
497,DF,10.9,11,6,9,2,0,8,18,44.4,10,5,2,3,18,29,29,0,497,DF,10.9,2,0,0,10,1,44,18,6,1,0,42,15,11,57.7
498,DF,7.5,14,8,10,4,0,5,10,50.0,5,14,2,12,10,24,18,0,498,DF,7.5,2,0,0,13,1,28,10,8,0,0,23,9,5,64.3
499,DF,1.0,2,1,2,0,0,2,3,66.7,1,2,1,1,0,2,1,0,499,DF,1.0,1,0,0,2,0,7,0,1,0,0,7,1,1,50.0
503,DF,0.1,0,0,0,0,0,0,0,,0,0,0,0,0,0,0,0,503,DF,0.1,0,0,0,0,0,0,0,0,0,0,0,0,0,
504,"MF,DF",6.1,24,18,13,9,2,13,24,54.2,11,16,0,16,9,33,4,0,504,"MF,DF",6.1,2,0,0,6,2,18,9,18,0,0,54,6,8,42.9
505,DF,30.0,59,42,40,17,2,35,59,59.3,24,66,43,23,45,104,145,0,505,DF,30.0,9,1,1,28,4,4,45,42,0,0,149,101,38,72.7
506,"DF,MF",0.4,1,0,1,0,0,0,0,,0,0,0,0,1,2,4,0,506,"DF,MF",0.4,0,0,0,0,0,2,1,0,0,0,6,0,3,0.0
509,DF,10.6,16,12,10,2,4,10,15,66.7,5,8,7,1,8,24,51,0,509,DF,10.6,1,0,0,3,0,0,8,12,0,0,46,19,22,46.3
511,"MF,DF",1.7,3,0,3,0,0,0,1,0.0,1,2,1,1,2,5,4,0,511,"MF,DF",1.7,1,0,0,3,0,0,2,0,0,0,8,1,1,50.0
512,"MF,DF",0.2,0,0,0,0,0,0,0,,0,0,0,0,0,0,0,0,512,"MF,DF",0.2,0,0,0,0,0,4,0,0,0,0,0,2,1,66.7
513,DF,33.0,57,34,33,22,2,32,63,50.8,31,58,34,24,53,110,139,3,513,DF,33.0,4,0,0,35,0,13,53,34,0,0,174,86,54,61.4
514,MF,0.3,0,0,0,0,0,0,0,,0,0,0,0,1,1,0,0,514,MF,0.3,0,0,0,0,0,0,1,0,0,0,1,0,0,
515,"DF,MF",13.0,23,18,15,6,2,11,17,64.7,6,15,3,12,6,29,29,1,515,"DF,MF",13.0,6,1,1,8,3,70,6,18,0,0,68,13,10,56.5
516,DF,5.3,6,5,2,2,2,3,9,33.3,6,2,0,2,5,11,11,0,516,DF,5.3,1,0,0,10,3,13,5,5,0,0,20,7,6,53.8
521,DF,1.7,8,5,5,1,2,5,7,71.4,2,2,1,1,3,11,9,0,521,DF,1.7,0,0,0,1,0,1,3,5,1,0,4,5,3,62.5
523,DF,8.4,15,10,5,9,1,5,8,62.5,3,11,3,8,4,19,19,1,523,DF,8.4,5,0,0,11,4,43,4,10,0,0,33,12,15,44.4
525,MF,28.8,50,28,20,29,1,30,76,39.5,46,22,5,17,31,81,28,0,525,MF,28.8,5,0,0,26,2,29,31,28,0,0,165,13,18,41.9
528,MF,28.7,81,52,45,25,11,48,96,50.0,48,47,21,26,44,125,60,0,528,MF,28.7,5,0,0,30,0,33,44,52,1,0,207,25,23,52.1
529,"DF,MF",22.0,23,14,7,14,2,16,28,57.1,12,23,10,13,21,44,41,0,529,"DF,MF",22.0,4,0,0,26,0,0,21,14,0,0,107,54,22,71.1
530,MF,2.4,10,6,7,3,0,4,7,57.1,3,8,2,6,4,14,4,0,530,MF,2.4,1,0,0,4,0,5,4,6,0,0,18,0,5,0.0
532,MF,32.3,86,44,34,35,17,39,92,42.4,53,52,11,41,52,138,53,1,532,MF,32.3,6,0,0,48,5,73,52,44,1,0,231,21,38,35.6
535,DF,27.0,34,22,22,12,0,16,26,61.5,10,38,23,15,14,48,107,3,535,DF,27.0,4,0,0,23,0,2,14,22,1,0,93,43,31,58.1
536,DF,20.7,29,18,23,5,1,18,32,56.3,14,27,21,6,11,40,92,1,536,DF,20.7,3,2,0,15,0,2,11,18,0,0,83,26,25,51.0
537,MF,18.5,44,24,16,26,2,16,29,55.2,13,27,10,17,30,74,54,0,537,MF,18.5,10,0,0,27,4,3,30,24,0,0,127,50,42,54.3
539,MF,0.0,0,0,0,0,0,0,0,,0,0,0,0,0,0,0,0,539,MF,0.0,0,0,0,0,0,0,0,0,0,0,0,0,0,
541,DF,0.2,1,1,1,0,0,1,1,100.0,0,1,1,0,0,1,0,0,541,DF,0.2,1,0,0,1,0,0,0,1,0,0,1,0,0,
542,DF,1.2,5,4,4,1,0,3,3,100.0,0,1,0,1,3,8,5,0,542,DF,1.2,0,0,0,2,0,0,3,4,0,0,8,2,4,33.3
543,"DF,MF",17.8,30,18,13,13,4,13,21,61.9,8,20,5,15,9,39,28,0,543,"DF,MF",17.8,2,0,0,29,4,53,9,18,1,0,56,7,9,43.8
544,MF,1.0,2,1,1,1,0,1,5,20.0,4,6,2,4,1,3,1,0,544,MF,1.0,0,0,0,4,0,0,1,1,0,0,6,0,0,
545,MF,14.5,30,17,14,11,5,11,39,28.2,28,24,3,21,11,41,15,1,545,MF,14.5,4,0,0,14,5,23,11,17,0,0,59,18,15,54.5
546,MF,5.6,12,5,3,6,3,1,5,20.0,4,4,1,3,5,17,7,0,546,MF,5.6,1,0,0,16,1,26,5,5,0,0,27,3,3,50.0
547,DF,23.0,47,20,22,19,6,26,49,53.1,23,17,3,14,36,83,46,0,547,DF,23.0,2,1,0,11,3,159,36,20,0,0,125,12,19,38.7
548,MF,0.0,2,0,2,0,0,2,2,100.0,0,1,0,1,0,2,0,0,548,MF,0.0,0,0,0,1,0,0,0,0,0,0,0,0,0,
549,DF,14.9,24,15,11,11,2,14,21,66.7,7,18,6,12,10,34,33,0,549,DF,14.9,0,0,0,6,0,9,10,15,0,0,50,13,8,61.9
551,DF,25.5,32,19,25,7,0,11,18,61.1,7,27,15,12,20,52,120,3,551,DF,25.5,6,1,0,19,0,1,20,19,0,1,104,58,37,61.1
552,DF,7.4,17,14,10,3,4,11,16,68.8,5,12,4,8,7,24,26,1,552,DF,7.4,0,0,0,6,0,13,7,14,0,1,39,1,4,20.0
553,DF,20.4,39,23,25,7,7,16,29,55.2,13,22,7,15,20,59,71,0,553,DF,20.4,3,0,0,11,0,34,20,23,0,0,83,23,14,62.2
554,DF,29.5,38,20,24,12,2,19,29,65.5,10,46,30,16,44,82,141,4,554,DF,29.5,3,0,0,12,3,4,44,20,0,0,136,73,35,67.6
555,DF,1.0,0,0,0,0,0,0,0,,0,0,0,0,2,2,4,0,555,DF,1.0,0,0,0,0,0,2,2,0,0,0,7,0,2,0.0
558,DF,20.0,48,30,26,17,5,26,34,76.5,8,28,10,18,26,74,66,0,558,DF,20.0,2,0,0,25,4,12,26,30,0,0,96,43,20,68.3
560,DF,22.2,42,28,28,13,1,28,38,73.7,10,35,18,17,36,78,77,1,560,DF,22.2,5,0,0,26,1,3,36,28,2,0,99,14,27,34.1
561,MF,18.4,44,26,15,21,8,19,38,50.0,19,33,9,24,22,66,27,1,561,MF,18.4,8,2,1,33,1,5,22,26,0,0,85,31,26,54.4
567,MF,31.0,61,41,24,30,7,34,63,54.0,29,32,11,21,65,126,46,1,567,MF,31.0,5,1,0,39,2,132,65,41,0,0,228,42,29,59.2
568,DF,14.8,45,27,27,17,1,30,43,69.8,13,12,6,6,32,77,47,1,568,DF,14.8,7,0,0,36,0,10,32,27,2,0,75,20,16,55.6
569,DF,18.2,36,22,25,9,2,20,33,60.6,13,26,9,17,27,63,89,1,569,DF,18.2,9,0,0,32,0,0,27,22,0,0,70,82,47,63.6
570,MF,10.1,20,12,8,10,2,5,13,38.5,8,14,4,10,16,36,15,0,570,MF,10.1,4,0,0,18,1,2,16,12,0,0,60,11,10,52.4
571,DF,2.2,10,4,9,1,0,4,9,44.4,5,2,0,2,5,15,3,0,571,DF,2.2,1,0,0,1,0,8,5,4,0,0,8,0,1,0.0
574,MF,0.3,2,0,0,2,0,1,3,33.3,2,0,0,0,1,3,1,0,574,MF,0.3,0,0,0,4,0,1,1,0,0,0,2,0,2,0.0
577,"MF,DF",0.2,0,0,0,0,0,0,0,,0,0,0,0,1,1,0,0,577,"MF,DF",0.2,0,0,0,1,0,2,1,0,0,0,2,0,0,
580,DF,23.9,63,35,39,20,4,28,49,57.1,21,39,16,23,33,96,61,0,580,DF,23.9,4,1,0,41,2,48,33,35,1,0,153,16,32,33.3
582,DF,9.2,18,9,9,7,2,9,19,47.4,10,17,4,13,16,34,24,0,582,DF,9.2,1,0,0,7,0,40,16,9,1,0,60,10,20,33.3
583,MF,16.6,18,10,5,12,1,10,23,43.5,13,21,4,17,16,34,8,1,583,MF,16.6,3,0,0,12,0,77,16,10,0,0,75,6,9,40.0
584,DF,18.7,38,22,23,10,5,18,29,62.1,11,14,4,10,16,54,35,0,584,DF,18.7,7,0,0,25,2,63,16,22,0,0,78,13,16,44.8
586,DF,29.4,40,24,31,9,0,15,24,62.5,9,42,27,15,23,63,120,1,586,DF,29.4,6,0,0,38,1,12,23,24,0,0,158,64,37,63.4
587,MF,25.6,91,50,40,46,5,46,93,49.5,47,28,14,14,39,130,59,3,587,MF,25.6,8,0,0,62,6,24,39,50,1,0,164,61,31,66.3
590,DF,34.8,64,41,50,12,2,38,75,50.7,37,49,15,34,43,107,97,0,590,DF,34.8,7,1,1,32,1,106,43,41,1,0,154,40,37,51.9
591,MF,23.1,47,32,20,21,6,22,49,44.9,27,23,5,18,16,63,29,0,591,MF,23.1,5,0,0,33,1,8,16,32,0,0,129,29,32,47.5
592,DF,0.0,0,0,0,0,0,0,0,,0,0,0,0,0,0,0,0,592,DF,0.0,0,0,0,0,0,0,0,0,0,0,0,0,0,
593,MF,1.3,7,4,2,3,2,3,8,37.5,5,4,0,4,0,7,0,0,593,MF,1.3,0,0,0,3,0,1,0,4,0,0,3,2,0,100.0
598,DF,9.9,35,23,23,10,2,17,24,70.8,7,7,0,7,14,49,32,0,598,DF,9.9,2,0,0,9,1,13,14,23,0,0,25,7,12,36.8
599,DF,3.1,8,6,4,4,0,2,7,28.6,5,3,0,3,4,12,6,0,599,DF,3.1,1,0,0,1,0,4,4,6,0,0,12,3,9,25.0
601,MF,5.9,16,9,8,6,2,9,17,52.9,8,15,6,9,10,26,7,0,601,MF,5.9,4,0,0,19,0,3,10,9,0,0,31,9,5,64.3
603,"MF,DF",36.5,72,41,33,28,11,28,50,56.0,22,36,6,30,25,97,55,2,603,"MF,DF",36.5,8,0,0,77,4,29,25,41,1,0,203,82,60,57.7
605,DF,18.5,27,15,16,10,1,17,25,68.0,8,14,7,7,12,39,39,1,605,DF,18.5,3,0,0,20,1,21,12,15,0,0,89,21,17,55.3
608,DF,3.0,4,3,2,2,0,3,5,60.0,2,6,1,5,1,5,2,0,608,DF,3.0,1,0,0,4,1,18,1,3,0,0,11,0,0,
609,DF,17.3,22,14,18,3,1,13,18,72.2,5,20,16,4,12,34,65,0,609,DF,17.3,4,0,0,15,0,1,12,14,1,0,59,28,26,51.9
610,DF,19.8,62,38,36,21,5,34,64,53.1,30,36,13,23,22,84,48,0,610,DF,19.8,10,0,0,23,1,16,22,38,1,1,96,22,17,56.4
612,DF,21.8,42,29,26,10,6,19,30,63.3,11,26,15,11,21,63,114,0,612,DF,21.8,7,0,0,25,0,13,21,29,0,0,82,60,38,61.2
613,MF,22.9,42,29,15,22,5,26,46,56.5,20,31,19,12,15,57,26,1,613,MF,22.9,9,0,0,24,0,26,15,29,0,0,141,19,24,44.2
616,"DF,MF",1.1,4,3,2,2,0,3,4,75.0,1,3,1,2,2,6,5,1,616,"DF,MF",1.1,0,0,0,0,0,0,2,3,0,0,11,0,1,0.0
617,DF,0.3,1,0,1,0,0,1,2,50.0,1,2,0,2,0,1,0,0,617,DF,0.3,0,0,0,0,0,1,0,0,0,0,1,0,0,
619,DF,17.1,57,34,34,20,3,28,41,68.3,13,22,13,9,14,71,31,0,619,DF,17.1,5,1,1,18,1,7,14,34,1,0,77,27,20,57.4
620,MF,0.3,2,1,2,0,0,0,0,,0,1,0,1,0,2,0,0,620,MF,0.3,0,0,0,4,0,1,0,1,0,0,2,0,0,
623,MF,5.0,9,4,2,4,3,3,9,33.3,6,4,1,3,1,10,5,0,623,MF,5.0,1,1,0,6,0,3,1,4,0,0,26,0,5,0.0
624,MF,2.5,5,1,1,4,0,3,7,42.9,4,4,0,4,0,5,1,0,624,MF,2.5,0,0,0,0,0,6,0,1,0,0,23,2,5,28.6
625,DF,11.7,12,5,4,7,1,1,10,10.0,9,13,6,7,12,24,38,2,625,DF,11.7,1,0,0,6,0,3,12,5,1,1,50,14,23,37.8
627,DF,35.3,81,51,58,12,11,51,74,68.9,23,44,16,28,37,118,111,0,627,DF,35.3,6,1,1,45,2,80,37,51,1,0,195,32,25,56.1
628,MF,9.4,29,17,13,9,7,14,40,35.0,26,23,1,22,11,40,10,1,628,MF,9.4,2,0,0,14,3,29,11,17,0,0,57,12,11,52.2
629,DF,8.3,19,11,12,5,2,9,19,47.4,10,13,4,9,8,27,15,0,629,DF,8.3,2,0,0,14,0,1,8,11,0,0,52,20,15,57.1
630,MF,19.9,36,18,22,12,2,21,46,45.7,25,34,8,26,35,71,42,0,630,MF,19.9,4,0,0,13,2,26,35,18,1,0,118,14,10,58.3
631,DF,27.2,60,36,38,18,4,32,48,66.7,16,34,15,19,37,97,94,0,631,DF,27.2,7,0,0,26,1,18,37,36,0,0,142,37,27,57.8
634,DF,29.5,24,14,12,11,1,15,30,50.0,15,43,30,13,23,47,115,1,634,DF,29.5,6,0,0,23,2,3,23,14,0,0,216,55,27,67.1
635,DF,31.6,62,30,44,16,2,38,52,73.1,14,43,22,21,37,99,77,2,635,DF,31.6,5,1,0,42,0,10,37,30,1,0,219,55,31,64.0
636,"DF,MF",0.3,1,1,1,0,0,1,2,50.0,1,0,0,0,0,1,2,0,636,"DF,MF",0.3,0,0,0,2,0,0,0,1,0,0,2,0,0,
638,MF,24.0,39,26,13,21,5,12,31,38.7,19,20,4,16,16,55,16,0,638,MF,24.0,4,0,0,19,1,149,16,26,0,0,124,8,14,36.4
640,DF,26.7,48,22,23,15,10,20,53,37.7,33,27,11,16,13,61,55,0,640,DF,26.7,2,0,0,27,1,21,13,22,2,0,74,20,17,54.1
645,DF,16.6,36,27,19,14,3,18,29,62.1,11,30,9,21,26,62,55,2,645,DF,16.6,6,0,0,27,1,33,26,27,0,0,68,58,21,73.4
647,DF,22.9,47,24,29,13,5,30,53,56.6,23,30,4,26,26,73,49,1,647,DF,22.9,0,0,0,16,0,31,26,24,1,0,179,14,9,60.9
648,DF,12.1,24,17,13,8,3,16,21,76.2,5,17,15,2,10,34,35,0,648,DF,12.1,2,0,0,8,0,10,10,17,0,0,53,29,21,58.0
649,MF,2.5,10,5,4,3,3,3,9,33.3,6,2,1,1,3,13,6,1,649,MF,2.5,2,0,0,7,0,4,3,5,1,0,21,3,3,50.0
651,DF,23.8,53,30,33,18,2,17,29,58.6,12,17,9,8,24,77,114,1,651,DF,23.8,5,0,0,33,0,2,24,30,0,1,139,67,30,69.1
652,DF,24.5,30,20,23,6,1,22,34,64.7,12,51,39,12,16,46,120,1,652,DF,24.5,7,0,0,20,4,1,16,20,0,0,100,63,32,66.3
653,MF,13.6,14,9,1,5,8,7,20,35.0,13,5,0,5,4,18,4,0,653,MF,13.6,2,0,0,11,1,136,4,9,0,0,54,6,5,54.5
655,MF,23.1,31,21,11,14,6,15,38,39.5,23,28,1,27,11,42,15,2,655,MF,23.1,7,0,0,27,1,46,11,21,0,0,145,5,4,55.6
656,DF,0.5,0,0,0,0,0,0,0,,0,1,0,1,1,1,2,0,656,DF,0.5,0,0,0,0,0,0,1,0,0,0,2,0,0,
657,DF,7.5,10,8,5,2,3,4,7,57.1,3,9,4,5,6,16,27,0,657,DF,7.5,0,0,0,3,0,9,6,8,0,0,21,9,5,64.3
658,DF,20.3,56,35,36,16,4,33,59,55.9,26,25,5,20,21,77,51,1,658,DF,20.3,7,1,0,38,2,31,21,35,1,0,87,17,21,44.7
659,DF,26.4,44,25,26,13,5,21,31,67.7,10,30,10,20,21,65,78,0,659,DF,26.4,8,1,1,37,0,5,21,25,1,0,120,58,38,60.4
661,MF,17.9,33,19,13,16,4,18,47,38.3,29,16,6,10,9,42,37,0,661,MF,17.9,7,0,0,25,0,15,9,19,0,1,87,35,30,53.8
663,"DF,MF",22.7,38,19,29,8,1,20,42,47.6,22,18,2,16,17,55,51,0,663,"DF,MF",22.7,5,0,0,39,1,104,17,19,1,0,77,17,17,50.0
665,DF,6.5,10,6,6,4,0,3,4,75.0,1,9,3,6,9,19,26,0,665,DF,6.5,2,0,0,6,0,5,9,6,0,0,29,8,9,47.1
666,DF,0.2,0,0,0,0,0,0,0,,0,1,1,0,1,1,0,0,666,DF,0.2,0,0,0,0,0,0,1,0,0,0,1,1,0,100.0
667,DF,15.2,28,15,21,4,3,18,38,47.4,20,24,8,16,14,42,49,1,667,DF,15.2,5,0,0,27,0,45,14,15,1,1,80,16,18,47.1
672,MF,0.8,1,1,0,1,0,0,1,0.0,1,0,0,0,0,1,0,0,672,MF,0.8,1,0,0,1,0,3,0,1,0,0,8,1,0,100.0
673,DF,31.5,38,23,20,15,3,15,26,57.7,11,66,36,30,43,81,159,2,673,DF,31.5,9,0,0,31,0,2,43,23,0,1,176,171,78,68.7
674,MF,1.3,6,4,3,2,1,4,5,80.0,1,5,2,3,2,8,3,1,674,MF,1.3,0,0,0,1,0,0,2,4,0,0,4,4,5,44.4
675,MF,0.3,0,0,0,0,0,0,0,,0,1,1,0,0,0,0,0,675,MF,0.3,0,0,0,0,0,0,0,0,0,0,4,2,0,100.0
677,DF,17.2,18,12,8,7,3,9,17,52.9,8,32,13,19,19,37,38,0,677,DF,17.2,2,0,0,17,1,30,19,12,0,0,91,22,17,56.4
680,MF,0.1,0,0,0,0,0,0,0,,0,0,0,0,1,1,0,0,680,MF,0.1,0,0,0,0,0,0,1,0,0,0,1,0,0,
684,DF,35.9,58,36,26,26,6,32,68,47.1,36,43,16,27,24,82,45,0,684,DF,35.9,6,0,0,28,5,126,24,36,0,0,141,27,39,40.9
685,"DF,MF",4.0,4,1,3,0,1,0,3,0.0,3,9,2,7,5,9,7,0,685,"DF,MF",4.0,0,0,0,3,1,18,5,1,2,0,26,4,2,66.7
688,MF,0.0,0,0,0,0,0,0,0,,0,0,0,0,0,0,0,0,688,MF,0.0,0,0,0,0,0,0,0,0,0,0,0,0,0,
689,"DF,MF",11.9,18,11,9,9,0,11,13,84.6,2,17,7,10,11,29,62,0,689,"DF,MF",11.9,6,0,0,9,0,0,11,11,0,0,67,25,13,65.8
691,DF,18.8,29,20,12,15,2,24,32,75.0,8,16,8,8,21,50,49,1,691,DF,18.8,4,0,0,16,2,3,21,20,1,0,83,32,19,62.7
692,DF,1.2,1,0,0,1,0,0,1,0.0,1,3,0,3,2,3,5,0,692,DF,1.2,0,0,0,5,0,9,2,0,0,0,12,3,2,60.0
693,MF,0.0,0,0,0,0,0,0,0,,0,0,0,0,0,0,0,0,693,MF,0.0,0,0,0,0,0,0,0,0,0,0,1,0,0,
696,MF,0.0,0,0,0,0,0,0,0,,0,0,0,0,0,0,0,0,696,MF,0.0,0,0,0,0,0,0,0,0,0,0,0,0,0,
699,DF,15.5,32,12,16,15,1,13,27,48.1,14,30,14,16,20,52,43,0,699,DF,15.5,5,0,0,22,0,16,20,12,0,0,63,21,16,56.8
700,DF,28.4,39,20,14,21,4,19,26,73.1,7,32,17,15,30,69,77,0,700,DF,28.4,0,0,0,23,0,13,30,20,1,1,108,47,42,52.8
703,MF,4.0,9,6,4,5,0,3,11,27.3,8,4,1,3,4,13,4,0,703,MF,4.0,2,0,0,10,0,2,4,6,0,0,18,3,4,42.9
706,"DF,MF",1.8,5,3,2,3,0,1,3,33.3,2,1,0,1,1,6,8,0,706,"DF,MF",1.8,1,0,0,0,0,0,1,3,0,0,6,3,1,75.0
710,DF,2.2,2,1,2,0,0,2,2,100.0,0,3,3,0,2,4,12,0,710,DF,2.2,0,0,0,0,2,0,2,1,0,0,7,3,5,37.5
711,DF,13.0,11,8,5,5,1,5,6,83.3,1,20,12,8,10,21,48,1,711,DF,13.0,1,0,0,12,1,7,10,8,0,0,66,34,15,69.4
714,DF,26.8,47,19,35,9,3,25,44,56.8,19,20,2,18,26,73,67,0,714,DF,26.8,7,0,0,29,3,154,26,19,0,0,101,42,24,63.6
715,DF,23.1,42,25,19,14,9,17,35,48.6,18,18,3,15,9,51,34,1,715,DF,23.1,0,0,0,12,5,196,9,25,0,0,99,6,9,40.0
717,"MF,DF",21.7,44,29,15,17,12,18,41,43.9,23,28,7,21,9,53,39,1,717,"MF,DF",21.7,5,0,0,49,3,21,9,29,0,0,112,41,32,56.2
719,DF,9.9,10,4,5,3,2,9,16,56.3,7,12,9,3,15,25,26,1,719,DF,9.9,2,0,0,12,0,1,15,4,0,0,73,16,13,55.2
720,"MF,DF",1.8,10,8,6,3,1,7,9,77.8,2,3,0,3,1,11,5,0,720,"MF,DF",1.8,3,0,0,7,0,2,1,8,1,0,11,3,2,60.0
721,DF,15.8,30,16,23,5,2,15,20,75.0,5,28,19,9,17,47,80,1,721,DF,15.8,4,1,1,17,0,0,17,16,3,0,65,25,17,59.5
723,MF,14.6,28,19,12,11,5,14,22,63.6,8,13,3,10,3,31,5,1,723,MF,14.6,2,0,0,12,0,47,3,19,0,0,94,10,14,41.7
725,DF,28.7,33,19,20,10,3,23,30,76.7,7,26,19,7,18,51,102,2,725,DF,28.7,6,0,0,17,4,10,18,19,0,1,150,72,31,69.9
726,DF,0.2,0,0,0,0,0,0,0,,0,1,0,1,0,0,1,0,726,DF,0.2,0,0,0,0,0,0,0,0,0,0,1,0,1,0.0
727,MF,0.1,0,0,0,0,0,0,0,,0,0,0,0,0,0,0,0,727,MF,0.1,0,0,0,1,0,1,0,0,0,0,0,0,1,0.0
728,"DF,MF",27.6,34,19,18,13,3,15,26,57.7,11,31,15,16,23,57,70,0,728,"DF,MF",27.6,14,1,1,51,1,30,23,19,1,0,175,37,29,56.1
729,DF,8.4,14,9,9,5,0,3,4,75.0,1,10,5,5,10,24,20,0,729,DF,8.4,2,0,0,11,0,2,10,9,0,0,37,8,6,57.1
730,DF,31.5,42,24,29,12,1,19,31,61.3,12,53,33,20,57,99,100,0,730,DF,31.5,5,0,0,17,0,6,57,24,1,0,171,92,55,62.6
733,"DF,MF",25.0,50,27,21,19,10,21,36,58.3,15,30,3,27,9,59,29,0,733,"DF,MF",25.0,2,0,0,26,2,61,9,27,0,0,97,21,28,42.9
734,MF,2.6,9,7,3,5,1,5,9,55.6,4,5,1,4,1,10,0,0,734,MF,2.6,1,0,0,3,0,7,1,7,0,0,20,2,1,66.7
735,DF,5.8,5,3,1,4,0,2,5,40.0,3,2,0,2,5,10,11,0,735,DF,5.8,0,0,0,7,0,19,5,3,0,0,34,4,2,66.7
736,DF,24.0,34,23,18,16,0,15,21,71.4,6,46,25,21,38,72,111,1,736,DF,24.0,2,0,0,13,0,4,38,23,0,0,68,53,42,55.8
737,"DF,MF",12.8,31,18,17,10,4,12,23,52.2,11,15,5,10,7,38,47,0,737,"DF,MF",12.8,2,0,0,13,5,13,7,18,0,0,65,38,33,53.5
738,DF,9.2,16,9,9,7,0,13,17,76.5,4,12,3,9,4,20,17,1,738,DF,9.2,2,0,0,7,1,30,4,9,1,0,36,5,7,41.7
739,DF,14.9,25,17,16,9,0,15,27,55.6,12,31,10,21,16,41,38,0,739,DF,14.9,5,0,0,15,0,47,16,17,1,0,49,15,14,51.7
743,DF,17.6,33,21,17,9,7,23,37,62.2,14,24,12,12,22,55,78,0,743,DF,17.6,2,0,0,15,0,3,22,21,0,2,71,36,30,54.5
746,MF,1.1,1,0,1,0,0,0,2,0.0,2,3,0,3,0,1,2,0,746,MF,1.1,0,0,0,3,0,0,0,0,0,0,7,1,0,100.0
747,DF,0.4,0,0,0,0,0,0,0,,0,0,0,0,0,0,1,1,747,DF,0.4,2,0,0,1,0,4,0,0,0,0,2,0,2,0.0
750,"DF,MF",17.4,43,22,22,17,4,22,34,64.7,12,16,5,11,9,52,45,2,750,"DF,MF",17.4,6,0,0,25,2,41,9,22,0,0,78,27,25,51.9
751,MF,15.4,35,24,13,21,1,13,33,39.4,20,15,9,6,16,51,27,0,751,MF,15.4,5,0,0,19,0,3,16,24,2,0,113,9,18,33.3
752,DF,33.1,55,35,43,12,0,32,48,66.7,16,50,27,23,45,100,172,2,752,DF,33.1,5,0,0,38,0,1,45,35,0,2,190,118,68,63.4
753,MF,7.9,14,7,3,8,3,4,13,30.8,9,12,2,10,4,18,4,0,753,MF,7.9,2,0,0,14,0,9,4,7,0,0,49,5,8,38.5
755,MF,10.2,34,17,15,13,6,18,30,60.0,12,13,2,11,20,54,12,0,755,MF,10.2,2,0,0,10,0,1,20,17,0,0,74,5,9,35.7
758,DF,13.7,28,21,14,12,2,22,32,68.8,10,12,1,11,15,43,65,1,758,DF,13.7,1,1,0,29,0,43,15,21,0,0,78,18,19,48.6
759,DF,32.5,63,40,29,18,16,37,82,45.1,45,51,9,42,31,94,43,4,759,DF,32.5,5,0,0,31,13,340,31,40,0,0,185,23,12,65.7
760,MF,19.7,70,42,34,30,6,30,59,50.8,29,22,8,14,26,96,30,0,760,MF,19.7,7,0,0,48,0,20,26,42,1,0,126,8,20,28.6
761,"MF,DF",18.4,23,16,7,14,2,13,21,61.9,8,19,7,12,19,42,29,2,761,"MF,DF",18.4,4,0,0,19,0,0,19,16,0,1,100,14,17,45.2
762,MF,9.8,28,18,8,10,10,10,29,34.5,19,14,0,14,9,37,6,0,762,MF,9.8,1,0,0,15,1,8,9,18,0,0,68,10,13,43.5
767,MF,13.6,26,13,11,10,5,14,23,60.9,9,22,9,13,12,38,18,0,767,MF,13.6,2,0,0,11,0,28,12,13,0,0,93,0,4,0.0
768,DF,4.8,5,3,5,0,0,3,3,100.0,0,5,4,1,8,13,19,0,768,DF,4.8,1,0,0,6,1,0,8,3,0,0,21,9,6,60.0
769,DF,19.0,16,11,9,6,1,8,9,88.9,1,18,12,6,21,37,87,3,769,DF,19.0,1,0,0,14,0,1,21,11,0,0,62,58,25,69.9
771,DF,6.4,16,9,12,4,0,8,17,47.1,9,12,8,4,8,24,14,0,771,DF,6.4,1,0,0,4,0,0,8,9,0,0,24,3,14,17.6
772,DF,10.1,7,4,6,0,1,5,7,71.4,2,7,5,2,8,15,27,0,772,DF,10.1,5,2,1,8,0,1,8,4,0,0,45,14,10,58.3
773,DF,20.9,39,20,21,16,2,21,31,67.7,10,21,6,15,23,62,69,0,773,DF,20.9,7,0,0,31,0,70,23,20,0,0,93,27,26,50.9
776,MF,27.3,59,39,17,35,7,31,52,59.6,21,29,12,17,26,85,21,0,776,MF,27.3,14,2,2,54,0,94,26,39,0,0,195,7,19,26.9
777,DF,18.2,22,13,9,11,2,9,23,39.1,14,15,6,9,12,34,33,1,777,DF,18.2,2,1,0,25,5,47,12,13,0,0,58,36,18,66.7
778,DF,0.2,1,0,1,0,0,1,1,100.0,0,0,0,0,0,1,1,0,778,DF,0.2,0,0,0,1,0,0,0,0,1,0,0,1,0,100.0
779,MF,21.0,35,22,13,15,7,15,35,42.9,20,27,5,22,11,46,13,0,779,MF,21.0,2,0,0,26,3,65,11,22,0,0,117,29,29,50.0
780,DF,31.9,27,14,17,9,1,13,36,36.1,23,49,37,12,31,58,90,1,780,DF,31.9,7,1,0,23,1,7,31,14,1,0,180,57,32,64.0
784,DF,15.0,37,19,16,17,4,18,44,40.9,26,17,5,12,18,55,34,0,784,DF,15.0,5,0,0,29,0,13,18,19,1,0,80,15,15,50.0
788,MF,0.2,1,1,0,1,0,1,1,100.0,0,1,1,0,0,1,1,0,788,MF,0.2,0,0,0,0,0,0,0,1,0,0,1,2,0,100.0
789,DF,18.9,33,20,23,9,1,21,35,60.0,14,33,2,31,10,43,27,0,789,DF,18.9,6,1,1,29,1,45,10,20,3,0,74,16,18,47.1
790,DF,0.1,1,1,1,0,0,0,1,0.0,1,0,0,0,1,2,0,0,790,DF,0.1,0,0,0,0,0,0,1,1,0,0,3,0,0,
791,DF,12.2,14,9,9,5,0,7,11,63.6,4,9,4,5,6,20,27,1,791,DF,12.2,0,0,0,7,3,23,6,9,0,0,70,8,18,30.8
793,MF,31.9,83,49,38,38,7,44,63,69.8,19,48,8,40,41,124,33,1,793,MF,31.9,8,0,0,45,0,17,41,49,0,0,188,35,25,58.3
795,DF,5.4,6,4,4,2,0,4,11,36.4,7,10,4,6,13,19,39,1,795,DF,5.4,2,0,0,6,0,0,13,4,1,0,21,14,8,63.6
796,MF,32.4,49,24,25,19,5,15,36,41.7,21,53,19,34,28,77,40,1,796,MF,32.4,6,0,0,32,2,9,28,24,1,0,167,51,43,54.3
797,"MF,DF",1.2,4,1,3,1,0,2,4,50.0,2,3,1,2,1,5,0,0,797,"MF,DF",1.2,1,0,0,2,0,0,1,1,0,0,8,0,0,
798,DF,10.6,22,14,16,4,2,11,18,61.1,7,21,3,18,8,30,36,0,798,DF,10.6,4,0,0,12,5,17,8,14,0,0,44,12,13,48.0
799,DF,4.9,4,2,2,2,0,2,4,50.0,2,10,5,5,6,10,21,0,799,DF,4.9,2,0,0,8,0,0,6,2,0,0,26,4,9,30.8
809,MF,0.3,0,0,0,0,0,0,1,0.0,1,0,0,0,1,1,0,0,809,MF,0.3,0,0,0,1,0,0,1,0,0,0,2,1,1,50.0
810,DF,9.0,11,7,5,4,2,6,14,42.9,8,12,10,2,7,18,26,0,810,DF,9.0,2,0,0,9,0,1,7,7,0,0,38,29,13,69.0
811,DF,27.6,33,18,22,10,1,18,24,75.0,6,40,25,15,43,76,150,2,811,DF,27.6,5,0,0,13,1,3,43,18,0,0,137,72,46,61.0
815,DF,12.9,36,24,23,10,3,21,43,48.8,22,23,10,13,20,56,50,1,815,DF,12.9,4,0,0,14,0,14,20,24,0,0,82,15,21,41.7
818,MF,19.1,48,28,11,31,6,20,61,32.8,41,24,2,22,20,68,31,3,818,MF,19.1,10,0,0,50,0,4,20,28,0,0,108,31,27,53.4
819,"MF,DF",15.6,33,18,15,14,4,12,29,41.4,17,23,1,22,15,48,21,0,819,"MF,DF",15.6,1,1,0,24,1,80,15,18,0,0,61,12,19,38.7
820,MF,12.7,18,13,5,10,3,12,33,36.4,21,17,6,11,4,22,13,0,820,MF,12.7,1,0,0,7,1,43,4,13,0,0,86,1,7,12.5
821,DF,29.1,37,22,26,8,3,20,30,66.7,10,31,16,15,28,65,128,1,821,DF,29.1,5,0,0,30,0,5,28,22,2,0,110,55,48,53.4
822,MF,18.9,39,24,16,14,9,20,55,36.4,35,23,5,18,26,65,33,2,822,MF,18.9,2,1,0,31,2,5,26,24,0,0,91,31,30,50.8
824,DF,27.9,67,45,43,22,2,30,82,36.6,52,26,4,22,40,107,63,0,824,DF,27.9,9,0,0,45,0,50,40,45,1,1,171,13,26,33.3
825,DF,0.0,1,1,1,0,0,1,1,100.0,0,0,0,0,0,1,2,0,825,DF,0.0,0,0,0,0,0,0,0,1,0,0,1,1,1,50.0
826,DF,14.5,27,10,15,12,0,18,32,56.3,14,21,10,11,27,54,56,0,826,DF,14.5,6,0,0,25,0,5,27,10,0,0,62,26,22,54.2
827,DF,11.1,16,12,11,5,0,10,15,66.7,5,13,9,4,18,34,50,0,827,DF,11.1,2,0,0,11,0,2,18,12,0,1,52,18,13,58.1
829,DF,13.8,26,13,12,11,3,14,30,46.7,16,14,4,10,21,47,20,0,829,DF,13.8,4,0,0,22,5,65,21,13,0,1,90,12,14,46.2
831,DF,15.5,22,14,20,2,0,12,21,57.1,9,25,18,7,23,45,76,0,831,DF,15.5,2,0,0,17,0,0,23,14,0,0,70,36,18,66.7
837,MF,4.9,5,3,1,3,1,3,7,42.9,4,3,0,3,4,9,1,0,837,MF,4.9,1,0,0,3,1,19,4,3,0,0,23,1,0,100.0
843,DF,28.3,41,26,29,11,1,21,36,58.3,15,38,24,14,27,68,120,0,843,DF,28.3,12,0,0,23,0,10,27,26,0,0,127,39,39,50.0
844,DF,6.7,13,10,5,6,2,7,10,70.0,3,9,5,4,6,19,21,0,844,DF,6.7,5,0,0,11,0,19,6,10,0,0,38,9,7,56.3
845,DF,4.4,9,4,5,2,2,5,11,45.5,6,3,1,2,5,14,14,0,845,DF,4.4,0,0,0,3,0,17,5,4,1,0,10,4,7,36.4
849,DF,15.1,18,11,14,4,0,8,14,57.1,6,22,19,3,17,35,99,1,849,DF,15.1,3,1,0,9,0,0,17,11,1,0,54,50,21,70.4
850,MF,13.7,49,25,27,13,9,30,53,56.6,23,21,3,18,12,61,18,0,850,MF,13.7,6,0,0,23,1,54,12,25,1,0,78,14,29,32.6
853,DF,4.2,12,9,9,3,0,9,12,75.0,3,4,1,3,4,16,12,0,853,DF,4.2,4,0,0,10,0,0,4,9,0,0,20,14,6,70.0
854,DF,4.0,7,3,5,2,0,4,5,80.0,1,10,4,6,4,11,16,0,854,DF,4.0,1,0,0,2,0,0,4,3,0,0,23,2,6,25.0
856,DF,32.5,37,21,18,14,5,16,25,64.0,9,45,35,10,46,83,178,2,856,DF,32.5,5,1,1,29,0,3,46,21,0,1,150,111,68,62.0
857,DF,17.6,35,25,19,13,3,19,34,55.9,15,21,6,15,31,66,45,0,857,DF,17.6,8,1,1,25,0,28,31,25,1,0,106,10,11,47.6
859,MF,30.1,37,21,16,17,4,16,37,43.2,21,25,8,17,17,54,27,1,859,MF,30.1,8,0,0,52,4,11,17,21,1,0,142,34,40,45.9
861,DF,14.3,25,16,15,9,1,16,24,66.7,8,14,6,8,22,47,52,0,861,DF,14.3,4,0,0,10,2,53,22,16,0,0,88,19,19,50.0
863,MF,14.3,19,9,10,9,0,11,22,50.0,11,17,5,12,15,34,30,0,863,MF,14.3,3,0,0,5,0,35,15,9,0,0,82,13,16,44.8
865,MF,24.5,50,22,22,18,10,27,65,41.5,38,36,13,23,17,67,28,0,865,MF,24.5,7,0,0,33,4,45,17,22,1,0,122,21,23,47.7
869,MF,5.1,9,8,2,4,3,5,9,55.6,4,2,0,2,7,16,9,0,869,MF,5.1,0,0,0,6,0,4,7,8,0,0,35,10,8,55.6
871,MF,0.1,1,1,1,0,0,0,0,,0,0,0,0,0,1,0,0,871,MF,0.1,0,0,0,0,0,0,0,1,0,0,0,0,1,0.0
873,DF,20.2,58,42,36,18,4,34,58,58.6,24,27,6,21,29,87,89,0,873,DF,20.2,9,0,0,35,2,21,29,42,1,0,106,18,14,56.3
874,MF,22.6,36,22,16,17,3,20,67,29.9,47,19,1,18,13,49,23,0,874,MF,22.6,6,0,0,48,0,38,13,22,1,0,174,10,20,33.3
880,"DF,MF",3.2,8,6,4,3,1,2,5,40.0,3,8,1,7,1,9,12,0,880,"DF,MF",3.2,1,0,0,4,0,11,1,6,0,0,10,0,5,0.0
881,"MF,DF",1.0,1,0,0,1,0,0,1,0.0,1,0,0,0,0,1,1,0,881,"MF,DF",1.0,1,0,0,2,0,0,0,0,0,0,5,2,7,22.2
883,DF,19.2,43,21,26,12,5,26,48,54.2,22,16,9,7,20,63,25,1,883,DF,19.2,5,0,0,11,2,122,20,21,0,0,97,7,17,29.2
887,MF,30.0,61,39,19,36,6,30,66,45.5,36,35,7,28,37,98,31,1,887,MF,30.0,3,0,0,37,1,14,37,39,1,1,230,17,16,51.5
888,DF,31.0,44,24,24,14,6,19,36,52.8,17,34,19,15,31,75,70,0,888,DF,31.0,2,0,0,15,2,73,31,24,0,1,148,37,22,62.7
889,DF,20.4,32,17,21,8,3,20,45,44.4,25,34,12,22,25,57,36,0,889,DF,20.4,9,1,1,26,4,37,25,17,0,0,97,16,19,45.7
897,DF,3.5,6,5,5,1,0,4,10,40.0,6,0,0,0,2,8,4,0,897,DF,3.5,0,0,0,8,1,6,2,5,0,0,16,0,3,0.0
899,"DF,MF",20.5,39,22,22,13,4,18,26,69.2,8,10,1,9,16,55,49,1,899,"DF,MF",20.5,3,0,0,24,2,42,16,22,0,0,111,10,17,37.0
900,DF,11.8,26,15,18,8,0,12,27,44.4,15,17,4,13,12,38,44,0,900,DF,11.8,1,0,0,18,0,18,12,15,0,0,58,26,16,61.9
902,MF,13.7,15,12,4,10,1,7,28,25.0,21,12,4,8,30,45,29,2,902,MF,13.7,5,0,0,20,0,4,30,12,0,0,63,17,19,47.2
903,DF,24.4,60,39,25,26,9,31,74,41.9,43,30,7,23,25,85,36,0,903,DF,24.4,4,0,0,33,0,118,25,39,0,0,96,17,26,39.5
905,MF,10.6,10,6,3,7,0,4,8,50.0,4,9,3,6,5,15,19,0,905,MF,10.6,1,0,0,12,1,11,5,6,0,0,38,14,15,48.3
906,MF,34.9,133,72,47,70,16,55,91,60.4,36,55,14,41,51,184,42,1,906,MF,34.9,6,0,0,49,1,12,51,72,1,0,197,31,29,51.7
907,MF,29.2,78,50,41,32,5,38,69,55.1,31,37,9,28,36,114,53,2,907,MF,29.2,9,0,0,44,0,9,36,50,1,0,137,20,27,42.6
908,DF,24.4,53,32,38,15,0,36,48,75.0,12,45,29,16,35,88,129,0,908,DF,24.4,6,0,0,31,1,4,35,32,1,0,138,40,41,49.4
909,DF,17.4,23,15,16,6,1,12,20,60.0,8,28,20,8,17,40,87,0,909,DF,17.4,1,0,0,10,0,2,17,15,0,0,68,37,19,66.1
910,DF,25.0,26,17,12,7,7,8,20,40.0,12,26,0,26,7,33,17,0,910,DF,25.0,6,0,0,21,12,93,7,17,0,0,94,13,13,50.0
914,MF,15.3,23,14,6,13,4,11,19,57.9,8,22,1,21,8,31,11,0,914,MF,15.3,1,0,0,8,1,114,8,14,0,0,79,33,30,52.4
919,DF,14.2,29,20,15,13,1,18,24,75.0,6,11,6,5,10,39,48,0,919,DF,14.2,5,0,0,27,0,0,10,20,0,0,62,35,18,66.0
920,DF,5.3,10,6,4,6,0,5,8,62.5,3,5,2,3,8,18,36,1,920,DF,5.3,2,0,0,9,0,0,8,6,0,0,20,17,5,77.3
922,MF,1.8,4,1,0,4,0,2,4,50.0,2,5,2,3,1,5,4,0,922,MF,1.8,1,0,0,3,0,3,1,1,0,0,15,1,3,25.0
923,"MF,DF",26.2,61,30,27,25,9,31,50,62.0,19,30,11,19,31,92,38,0,923,"MF,DF",26.2,5,0,0,26,1,8,31,30,1,0,140,46,36,56.1
925,DF,1.0,5,4,2,2,1,4,5,80.0,1,1,0,1,1,6,3,0,925,DF,1.0,1,0,0,1,0,6,1,4,0,0,7,3,1,75.0
926,DF,11.9,38,22,15,19,4,15,30,50.0,15,24,1,23,14,52,17,1,926,DF,11.9,3,0,0,21,3,46,14,22,1,0,61,7,6,53.8
927,MF,23.2,49,31,15,26,8,24,49,49.0,25,18,5,13,12,61,17,0,927,MF,23.2,7,0,0,54,0,57,12,31,0,1,152,22,23,48.9
928,"MF,DF",0.1,0,0,0,0,0,0,0,,0,1,0,1,0,0,0,0,928,"MF,DF",0.1,0,0,0,1,0,0,0,0,0,0,2,1,1,50.0
929,MF,34.8,85,52,37,31,17,33,77,42.9,44,50,11,39,43,128,34,0,929,MF,34.8,9,1,1,83,1,64,43,52,0,0,221,25,28,47.2
930,DF,27.7,43,27,31,11,1,31,49,63.3,18,34,9,25,25,68,67,0,930,DF,27.7,2,0,0,9,3,138,25,27,0,0,161,25,33,43.1
931,DF,13.2,24,18,12,11,1,14,33,42.4,19,20,7,13,15,39,34,1,931,DF,13.2,6,0,0,14,0,23,15,18,1,0,74,12,9,57.1
933,MF,20.9,73,44,32,27,14,29,46,63.0,17,24,7,17,28,101,16,0,933,MF,20.9,8,0,0,35,0,11,28,44,0,0,174,13,9,59.1
935,MF,35.5,49,28,17,26,6,28,54,51.9,26,45,17,28,36,85,53,3,935,MF,35.5,4,1,0,29,1,192,36,28,0,0,208,17,23,42.5
937,MF,8.3,17,11,4,7,6,12,24,50.0,12,9,3,6,8,25,11,0,937,MF,8.3,4,0,0,11,0,0,8,11,0,0,40,7,8,46.7
938,DF,25.9,29,18,19,9,1,16,26,61.5,10,40,19,21,18,47,115,2,938,DF,25.9,5,0,0,33,1,2,18,18,1,0,129,93,35,72.7
939,DF,0.6,0,0,0,0,0,0,0,,0,1,1,0,0,0,0,0,939,DF,0.6,1,0,0,1,0,0,0,0,0,0,3,1,0,100.0
940,DF,29.3,55,37,34,18,3,34,49,69.4,15,36,18,18,30,85,79,2,940,DF,29.3,4,0,0,24,3,10,30,37,0,0,128,49,37,57.0
941,DF,15.5,25,17,11,12,2,13,31,41.9,18,16,3,13,19,44,28,1,941,DF,15.5,2,0,0,10,10,60,19,17,0,0,104,7,15,31.8
947,DF,10.1,21,16,6,13,2,13,20,65.0,7,8,3,5,7,28,13,2,947,DF,10.1,0,0,0,15,0,49,7,16,0,0,45,17,10,63.0
948,DF,6.2,12,9,9,2,1,5,10,50.0,5,7,1,6,8,20,18,0,948,DF,6.2,6,1,1,9,0,5,8,9,0,0,21,4,7,36.4
950,MF,33.4,83,44,32,38,13,35,82,42.7,47,45,14,31,45,128,47,1,950,MF,33.4,7,0,0,39,3,112,45,44,0,0,172,23,24,48.9
951,"MF,DF",5.4,10,5,7,2,1,5,15,33.3,10,13,0,13,4,14,8,1,951,"MF,DF",5.4,1,0,0,6,0,16,4,5,0,0,34,3,7,30.0
952,DF,8.2,22,12,14,5,3,13,19,68.4,6,15,8,7,15,37,50,1,952,DF,8.2,1,0,0,11,0,6,15,12,0,1,15,15,4,78.9
953,MF,25.1,43,22,18,21,4,23,81,28.4,58,31,9,22,36,79,24,4,953,MF,25.1,7,0,0,31,1,39,36,22,0,0,165,17,16,51.5
954,DF,29.3,33,19,16,16,1,19,24,79.2,5,26,15,11,19,52,90,1,954,DF,29.3,7,0,0,39,0,19,19,19,0,2,116,50,31,61.7
959,MF,0.7,1,0,1,0,0,0,0,,0,1,1,0,0,1,0,0,959,MF,0.7,1,0,0,2,0,0,0,0,0,0,1,1,1,50.0
961,"MF,DF",17.3,19,13,8,4,7,10,24,41.7,14,19,3,16,11,30,27,1,961,"MF,DF",17.3,3,0,0,15,1,53,11,13,0,0,82,15,16,48.4
963,DF,33.8,55,33,35,16,4,30,46,65.2,16,40,11,29,35,90,99,0,963,DF,33.8,5,0,0,27,3,61,35,33,1,0,104,53,39,57.6
965,"MF,DF",18.1,31,20,16,12,3,9,32,28.1,23,15,2,13,7,38,35,0,965,"MF,DF",18.1,5,0,0,18,2,27,7,20,0,0,78,28,27,50.9
966,"MF,DF",0.6,0,0,0,0,0,0,1,0.0,1,0,0,0,0,0,0,0,966,"MF,DF",0.6,0,0,0,1,0,1,0,0,0,0,2,0,0,
968,DF,8.2,28,19,19,7,2,17,31,54.8,14,9,2,7,5,33,12,0,968,DF,8.2,5,0,0,13,2,42,5,19,0,0,39,4,12,25.0
969,DF,7.0,9,4,7,2,0,4,5,80.0,1,10,6,4,19,28,39,0,969,DF,7.0,4,0,0,9,0,0,19,4,0,1,25,8,8,50.0
971,DF,19.2,33,22,16,13,4,13,19,68.4,6,28,18,10,25,58,93,1,971,DF,19.2,7,1,0,21,1,6,25,22,1,0,80,47,16,74.6
974,DF,20.1,32,14,23,8,1,19,34,55.9,15,27,14,13,20,52,69,0,974,DF,20.1,4,1,1,21,1,8,20,14,0,0,109,29,43,40.3
975,DF,2.3,4,0,4,0,0,2,5,40.0,3,6,3,3,3,7,11,0,975,DF,2.3,1,0,0,4,0,1,3,0,0,0,9,2,4,33.3
976,"DF,MF",5.6,8,6,4,3,1,2,7,28.6,5,2,0,2,4,12,22,0,976,"DF,MF",5.6,0,0,0,2,0,49,4,6,0,0,21,3,0,100.0
977,MF,23.6,26,16,14,10,2,11,35,31.4,24,23,9,14,11,37,14,1,977,MF,23.6,8,1,0,22,0,34,11,16,0,0,132,11,20,35.5
978,DF,22.5,40,24,25,14,1,19,35,54.3,16,27,17,10,16,56,101,1,978,DF,22.5,9,0,0,40,0,3,16,24,2,1,87,48,41,53.9
979,MF,6.0,11,7,3,8,0,4,7,57.1,3,10,4,6,4,15,9,1,979,MF,6.0,2,0,0,9,0,22,4,7,0,0,37,7,5,58.3
980,DF,21.3,29,15,19,9,1,16,29,55.2,13,40,26,14,16,45,93,0,980,DF,21.3,3,0,0,8,0,16,16,15,0,1,100,50,29,63.3
983,"DF,MF",15.1,44,22,18,25,1,17,30,56.7,13,26,14,12,19,63,42,2,983,"DF,MF",15.1,7,1,0,23,0,7,19,22,1,0,69,34,27,55.7
985,DF,12.4,30,20,17,8,5,15,28,53.6,13,14,8,6,16,46,57,0,985,DF,12.4,2,0,0,8,2,21,16,20,1,0,45,25,24,51.0
986,DF,11.2,12,7,9,3,0,4,10,40.0,6,11,7,4,15,27,37,1,986,DF,11.2,3,0,0,14,3,10,15,7,0,0,37,18,18,50.0
990,MF,28.6,26,13,4,15,7,14,32,43.8,18,23,6,17,18,44,28,1,990,MF,28.6,5,0,0,31,0,45,18,13,0,0,125,7,13,35.0
991,MF,29.4,128,74,67,49,12,44,99,44.4,55,51,8,43,18,146,29,2,991,MF,29.4,11,0,0,66,1,25,18,74,2,0,183,18,25,41.9
992,DF,30.8,44,25,32,8,4,24,37,64.9,13,40,19,21,26,70,93,2,992,DF,30.8,7,0,0,38,2,13,26,25,0,0,136,56,30,65.1
993,DF,19.8,47,31,24,16,7,30,63,47.6,33,26,4,22,19,66,50,2,993,DF,19.8,5,0,0,28,0,39,19,31,0,0,111,31,10,75.6
998,MF,9.7,12,10,2,6,4,5,10,50.0,5,13,2,11,2,14,9,0,998,MF,9.7,1,0,0,11,0,21,2,10,0,0,45,13,15,46.4
999,MF,1.5,4,1,2,2,0,0,1,0.0,1,2,0,2,2,6,2,0,999,MF,1.5,0,0,0,2,1,1,2,1,0,0,10,3,0,100.0
1000,MF,14.4,47,33,14,27,6,25,57,43.9,32,18,3,15,20,67,11,0,1000,MF,14.4,4,0,0,28,0,1,20,33,0,0,97,15,9,62.5
1001,"DF,MF",28.0,45,21,22,20,3,25,49,51.0,24,48,28,20,38,83,130,3,1001,"DF,MF",28.0,7,1,1,29,3,2,38,21,1,0,93,70,59,54.3
1002,"MF,DF",0.0,0,0,0,0,0,0,1,0.0,1,0,0,0,0,0,0,0,1002,"MF,DF",0.0,0,0,0,0,0,0,0,0,0,0,0,0,0,
1003,MF,1.4,2,2,2,0,0,1,2,50.0,1,2,0,2,0,2,0,0,1003,MF,1.4,1,0,0,1,0,2,0,2,0,0,13,1,2,33.3
1004,DF,27.4,73,45,37,32,4,40,81,49.4,41,24,3,21,31,104,60,2,1004,DF,27.4,6,0,0,38,3,62,31,45,1,0,154,37,36,50.7
1006,MF,0.1,1,0,1,0,0,0,0,,0,0,0,0,0,1,1,0,1006,MF,0.1,0,0,0,0,0,0,0,0,0,0,0,0,0,
1007,MF,14.3,31,18,16,12,3,17,28,60.7,11,20,3,17,5,36,9,0,1007,MF,14.3,6,0,0,15,1,10,5,18,0,0,81,25,36,41.0
1009,MF,1.7,4,1,0,3,1,2,2,100.0,0,1,0,1,1,5,6,0,1009,MF,1.7,1,0,0,1,0,0,1,1,0,0,13,5,4,55.6
1012,MF,0.0,1,1,0,1,0,1,1,100.0,0,0,0,0,1,2,0,0,1012,MF,0.0,0,0,0,0,0,0,1,1,0,0,0,0,0,
1013,MF,24.9,41,23,18,14,9,24,54,44.4,30,44,8,36,31,72,42,1,1013,MF,24.9,3,0,0,23,2,10,31,23,0,0,171,36,29,55.4
1015,DF,31.7,62,42,40,17,5,38,75,50.7,37,24,8,16,28,90,69,0,1015,DF,31.7,6,0,0,29,0,81,28,42,1,0,164,25,57,30.5
1016,"DF,MF",25.4,63,44,25,31,7,30,44,68.2,14,52,9,43,36,99,75,0,1016,"DF,MF",25.4,9,1,1,29,17,64,36,44,1,0,100,60,44,57.7
1017,MF,23.0,51,34,18,25,8,28,62,45.2,34,19,3,16,14,65,10,0,1017,MF,23.0,5,1,1,14,1,54,14,34,1,0,152,8,13,38.1
1019,DF,28.8,35,23,13,17,5,16,25,64.0,9,44,24,20,35,70,108,0,1019,DF,28.8,7,0,0,25,4,18,35,23,0,0,156,52,39,57.1
1021,DF,23.5,32,20,15,14,3,19,35,54.3,16,30,17,13,37,69,61,0,1021,DF,23.5,9,1,0,31,0,17,37,20,1,0,118,55,51,51.9
1024,MF,20.1,30,18,13,13,4,10,26,38.5,16,26,11,15,41,71,37,0,1024,MF,20.1,6,1,1,22,0,5,41,18,0,1,124,28,30,48.3
1025,MF,12.5,26,12,5,13,8,12,29,41.4,17,20,2,18,14,40,11,0,1025,MF,12.5,0,0,0,20,0,4,14,12,0,0,74,10,14,41.7
1035,"DF,MF",25.5,54,28,31,19,4,22,54,40.7,32,41,20,21,52,106,90,2,1035,"DF,MF",25.5,8,0,0,27,0,17,52,28,0,0,171,34,31,52.3
1036,DF,30.9,45,24,26,10,9,30,55,54.5,25,32,7,25,22,67,41,0,1036,DF,30.9,1,0,0,14,3,202,22,24,0,0,168,12,19,38.7
1037,"DF,MF",8.9,21,16,11,9,1,11,25,44.0,14,17,6,11,13,34,28,1,1037,"DF,MF",8.9,1,0,0,15,2,8,13,16,1,0,54,16,28,36.4
1038,"MF,DF",34.6,70,46,33,21,16,31,72,43.1,41,41,8,33,22,92,32,3,1038,"MF,DF",34.6,6,0,0,23,3,238,22,46,1,0,144,14,17,45.2
1040,MF,0.0,0,0,0,0,0,0,0,,0,0,0,0,0,0,0,0,1040,MF,0.0,0,0,0,0,0,0,0,0,0,0,0,0,0,
1042,MF,5.0,17,12,5,9,3,7,14,50.0,7,4,2,2,6,23,5,0,1042,MF,5.0,2,0,0,10,0,11,6,12,0,0,37,4,7,36.4
1044,"DF,MF",19.4,31,24,18,10,3,17,31,54.8,14,17,9,8,27,58,56,0,1044,"DF,MF",19.4,7,0,0,30,0,3,27,24,0,0,85,41,21,66.1
1048,DF,22.5,28,19,21,7,0,14,24,58.3,10,22,17,5,18,46,89,1,1048,DF,22.5,2,0,0,14,0,3,18,19,0,0,120,29,29,50.0
1049,MF,26.3,34,15,11,18,5,21,49,42.9,28,24,6,18,21,55,24,1,1049,MF,26.3,3,1,0,26,0,42,21,15,1,0,120,12,25,32.4
1050,MF,0.2,0,0,0,0,0,0,0,,0,1,1,0,0,0,0,0,1050,MF,0.2,0,0,0,0,0,1,0,0,0,0,1,0,1,0.0
1051,MF,27.8,54,24,25,22,7,22,58,37.9,36,27,7,20,18,72,44,0,1051,MF,27.8,3,1,0,40,2,24,18,24,0,0,177,25,32,43.9
1052,"DF,MF",13.2,19,16,6,9,4,9,15,60.0,6,7,1,6,15,34,5,1,1052,"DF,MF",13.2,2,0,0,3,0,42,15,16,0,0,59,2,5,28.6
1053,DF,0.5,1,1,0,1,0,1,1,100.0,0,1,0,1,0,1,0,0,1053,DF,0.5,0,0,0,0,0,0,0,1,0,0,3,1,1,50.0
1055,MF,32.6,59,32,28,25,6,31,64,48.4,33,34,12,22,13,72,46,1,1055,MF,32.6,7,0,0,48,0,8,13,32,0,0,218,45,41,52.3
1056,"MF,DF",8.5,33,21,11,19,3,13,19,68.4,6,17,3,14,13,46,12,0,1056,"MF,DF",8.5,2,0,0,20,1,9,13,21,0,0,52,15,9,62.5
1057,DF,4.5,15,10,10,5,0,6,7,85.7,1,13,7,6,13,28,21,0,1057,DF,4.5,1,0,0,5,0,0,13,10,0,0,29,7,6,53.8
1059,"DF,MF",27.7,87,50,49,30,8,47,72,65.3,25,39,10,29,71,158,99,1,1059,"DF,MF",27.7,3,0,0,35,2,85,71,50,0,0,136,23,41,35.9
1060,MF,14.6,24,15,7,14,3,11,17,64.7,6,8,3,5,12,36,25,2,1060,MF,14.6,7,0,0,36,0,6,12,15,1,0,80,15,15,50.0
1061,MF,36.3,88,53,45,32,11,40,77,51.9,37,52,14,38,35,123,20,0,1061,MF,36.3,9,0,0,50,0,32,35,53,0,0,237,18,23,43.9
1065,DF,22.7,37,23,23,13,1,17,23,73.9,6,24,14,10,25,62,82,0,1065,DF,22.7,5,1,1,17,1,3,25,23,0,0,78,49,33,59.8
1067,MF,29.7,55,34,21,30,4,23,62,37.1,39,24,5,19,25,80,30,2,1067,MF,29.7,12,0,0,62,0,150,25,34,0,0,126,23,24,48.9
1068,DF,5.3,6,5,1,3,2,1,5,20.0,4,13,5,8,7,13,15,0,1068,DF,5.3,3,0,0,7,0,8,7,5,0,0,22,3,2,60.0
1069,MF,33.3,32,22,14,16,2,12,39,30.8,27,19,4,15,21,53,18,1,1069,MF,33.3,5,0,0,15,6,157,21,22,0,0,189,7,18,28.0
1070,DF,11.8,20,12,9,11,0,7,18,38.9,11,9,3,6,2,22,16,0,1070,DF,11.8,1,0,0,8,1,62,2,12,0,0,32,5,10,33.3
1071,MF,29.8,42,24,10,27,5,12,45,26.7,33,23,3,20,22,64,22,0,1071,MF,29.8,2,0,0,21,2,21,22,24,0,0,131,45,47,48.9
1073,DF,19.5,55,27,34,15,6,35,52,67.3,17,28,4,24,17,72,43,1,1073,DF,19.5,7,1,0,22,6,64,17,27,1,0,126,8,19,29.6
1074,DF,33.7,29,18,11,14,4,13,35,37.1,22,27,11,16,22,51,66,2,1074,DF,33.7,4,0,0,27,6,97,22,18,2,0,203,22,18,55.0
1076,DF,25.9,55,33,21,24,10,21,38,55.3,17,36,12,24,27,82,37,3,1076,DF,25.9,3,0,0,20,2,33,27,33,0,0,150,31,24,56.4
1078,DF,19.6,36,18,30,6,0,20,26,76.9,6,33,23,10,23,59,77,2,1078,DF,19.6,9,0,0,33,0,0,23,18,1,1,111,31,28,52.5
1080,MF,1.0,5,3,1,2,2,3,3,100.0,0,1,0,1,1,6,1,0,1080,MF,1.0,1,0,0,1,0,0,1,3,0,0,9,3,0,100.0
1081,"MF,DF",13.6,36,24,16,13,7,22,45,48.9,23,21,4,17,12,48,18,0,1081,"MF,DF",13.6,7,0,0,22,1,15,12,24,0,0,95,20,19,51.3
1085,DF,1.2,6,4,5,1,0,1,2,50.0,1,0,0,0,3,9,2,0,1085,DF,1.2,0,0,0,4,0,12,3,4,0,0,14,1,0,100.0
1087,MF,17.0,42,27,24,16,2,23,41,56.1,18,28,6,22,21,63,37,0,1087,MF,17.0,5,0,0,14,2,4,21,27,0,0,96,34,18,65.4
1088,DF,8.2,9,8,5,3,1,4,6,66.7,2,7,2,5,11,20,32,3,1088,DF,8.2,1,0,0,11,2,22,11,8,1,0,33,14,8,63.6
1089,"DF,MF",4.4,8,7,5,2,1,2,9,22.2,7,5,1,4,6,14,10,0,1089,"DF,MF",4.4,1,0,0,13,1,10,6,7,0,0,26,3,5,37.5
1090,DF,21.5,29,19,14,9,6,17,34,50.0,17,28,4,24,12,41,28,2,1090,DF,21.5,3,0,0,22,3,79,12,19,1,0,142,9,12,42.9
1091,DF,8.7,28,18,17,10,1,17,28,60.7,11,17,2,15,12,40,22,1,1091,DF,8.7,2,0,0,5,0,23,12,18,0,0,56,10,11,47.6
1093,MF,32.3,39,21,17,15,7,16,59,27.1,43,33,9,24,29,68,35,0,1093,MF,32.3,9,0,0,50,6,115,29,21,1,0,162,6,16,27.3
1094,DF,11.0,20,12,10,8,2,10,16,62.5,6,10,4,6,11,31,41,0,1094,DF,11.0,5,0,0,13,1,0,11,12,1,0,38,29,15,65.9
1095,MF,0.3,0,0,0,0,0,0,1,0.0,1,1,0,1,1,1,0,0,1095,MF,0.3,1,0,0,1,0,0,1,0,0,0,4,0,0,
1096,DF,8.6,7,6,3,2,2,5,8,62.5,3,3,0,3,6,13,11,1,1096,DF,8.6,0,0,0,3,1,16,6,6,0,0,33,10,6,62.5
1097,MF,0.3,1,1,1,0,0,0,0,,0,0,0,0,0,1,1,0,1097,MF,0.3,0,0,0,2,0,0,0,1,0,0,2,0,0,
1099,MF,0.8,1,1,1,0,0,0,1,0.0,1,0,0,0,0,1,0,0,1099,MF,0.8,0,0,0,2,0,0,0,1,0,0,3,0,0,
1102,"DF,MF",2.4,4,2,2,2,0,3,6,50.0,3,2,1,1,2,6,5,0,1102,"DF,MF",2.4,1,0,0,4,0,1,2,2,1,0,13,4,3,57.1
1103,DF,6.6,11,5,6,4,1,5,11,45.5,6,12,7,5,8,19,20,0,1103,DF,6.6,0,0,0,10,0,9,8,5,0,2,26,12,12,50.0
1104,DF,12.4,12,5,8,2,2,5,15,33.3,10,21,7,14,4,16,21,0,1104,DF,12.4,5,0,0,16,0,34,4,5,1,0,34,18,11,62.1
1105,DF,9.5,22,10,12,10,0,10,17,58.8,7,14,5,9,13,35,30,1,1105,DF,9.5,1,0,0,7,0,6,13,10,0,0,50,5,9,35.7
1107,DF,0.1,0,0,0,0,0,0,0,,0,0,0,0,0,0,0,0,1107,DF,0.1,0,0,0,0,0,0,0,0,0,0,0,0,1,0.0
1108,DF,26.3,47,26,25,19,3,27,45,60.0,18,49,27,22,30,77,76,4,1108,DF,26.3,4,0,0,14,0,4,30,26,1,0,130,66,34,66.0
1110,"MF,DF",1.3,6,1,2,3,1,4,7,57.1,3,2,0,2,0,6,1,0,1110,"MF,DF",1.3,0,0,0,2,0,2,0,1,0,0,3,2,2,50.0
1112,DF,6.3,12,5,6,6,0,8,12,66.7,4,6,1,5,3,15,28,0,1112,DF,6.3,0,0,0,7,1,23,3,5,0,0,30,11,11,50.0
1114,MF,0.1,0,0,0,0,0,0,0,,0,0,0,0,0,0,0,0,1114,MF,0.1,0,0,0,0,0,1,0,0,0,0,0,0,0,
1115,DF,28.1,68,39,32,26,10,27,58,46.6,31,49,4,45,33,101,37,0,1115,DF,28.1,5,0,0,27,2,67,33,39,2,0,163,23,22,51.1
1116,DF,6.7,10,6,6,4,0,6,11,54.5,5,8,2,6,10,20,3,0,1116,DF,6.7,2,0,0,7,0,17,10,6,0,0,24,5,5,50.0
1119,MF,27.8,43,29,21,18,4,18,43,41.9,25,18,8,10,25,68,31,6,1119,MF,27.8,8,1,1,21,2,26,25,29,0,0,141,14,12,53.8
1120,DF,4.5,7,5,3,3,1,6,7,85.7,1,8,3,5,5,12,5,1,1120,DF,4.5,1,0,0,4,2,11,5,5,0,0,24,4,5,44.4
1122,DF,18.0,32,15,24,7,1,13,23,56.5,10,16,9,7,18,50,68,2,1122,DF,18.0,4,1,0,14,0,1,18,15,0,0,77,17,16,51.5
1123,DF,28.4,46,25,29,13,4,28,51,54.9,23,27,9,18,30,76,93,0,1123,DF,28.4,9,0,0,32,1,38,30,25,0,0,168,46,32,59.0
1124,DF,27.9,43,24,26,12,5,25,46,54.3,21,34,9,25,19,62,72,1,1124,DF,27.9,10,0,0,45,1,127,19,24,0,0,139,31,27,53.4
1125,DF,18.8,10,8,5,4,1,4,11,36.4,7,19,14,5,14,24,98,1,1125,DF,18.8,3,0,0,11,0,0,14,8,1,0,86,35,18,66.0
1126,DF,21.2,52,36,28,15,9,29,50,58.0,21,21,5,16,27,79,38,0,1126,DF,21.2,6,0,0,23,1,19,27,36,0,0,124,23,16,59.0
1127,DF,8.0,7,3,4,3,0,4,8,50.0,4,3,2,1,8,15,25,0,1127,DF,8.0,4,0,0,8,0,2,8,3,0,0,24,9,2,81.8
1128,DF,31.0,30,17,19,11,0,11,22,50.0,11,33,13,20,23,53,42,1,1128,DF,31.0,11,1,0,38,2,68,23,17,1,0,172,29,18,61.7
1129,DF,18.3,29,19,23,6,0,12,19,63.2,7,20,11,9,15,44,69,1,1129,DF,18.3,4,0,0,26,0,0,15,19,0,0,49,26,25,51.0
1130,MF,11.4,44,32,11,26,7,20,36,55.6,16,16,6,10,15,59,18,1,1130,MF,11.4,4,0,0,21,0,13,15,32,0,0,76,14,24,36.8
1133,MF,23.4,64,37,28,30,6,30,56,53.6,26,30,8,22,24,88,45,1,1133,MF,23.4,9,0,0,65,2,29,24,37,0,0,125,61,44,58.1
1135,DF,3.2,6,5,5,1,0,3,6,50.0,3,4,1,3,2,8,17,0,1135,DF,3.2,1,0,0,1,0,0,2,5,0,0,13,4,3,57.1
1137,DF,7.9,16,9,9,3,4,7,7,100.0,0,7,3,4,3,19,10,0,1137,DF,7.9,5,0,0,10,0,5,3,9,0,0,42,1,9,10.0
1138,DF,9.6,17,10,10,7,0,10,19,52.6,9,12,5,7,7,24,33,1,1138,DF,9.6,1,1,0,11,0,0,7,10,0,0,66,34,24,58.6
1139,DF,10.4,18,12,8,10,0,7,15,46.7,8,12,5,7,14,32,33,0,1139,DF,10.4,3,0,0,18,2,0,14,12,0,0,60,36,15,70.6
1140,DF,0.8,3,2,1,2,0,1,1,100.0,0,3,2,1,3,6,8,0,1140,DF,0.8,0,0,0,1,0,0,3,2,0,0,7,4,1,80.0
1141,DF,16.5,35,22,14,17,4,13,17,76.5,4,18,7,11,13,48,43,0,1141,DF,16.5,2,0,0,16,0,8,13,22,0,0,78,36,27,57.1
1142,DF,9.7,14,5,7,4,3,5,13,38.5,8,6,2,4,14,28,18,0,1142,DF,9.7,1,0,0,11,1,10,14,5,1,0,33,7,8,46.7
1144,MF,25.9,63,40,36,20,7,22,49,44.9,27,30,16,14,31,94,45,0,1144,MF,25.9,10,1,0,29,0,2,31,40,0,0,152,49,48,50.5
1145,MF,24.5,20,14,6,9,5,10,24,41.7,14,18,0,18,8,28,6,0,1145,MF,24.5,3,0,0,14,13,126,8,14,0,0,77,2,8,20.0
1148,DF,7.9,12,7,5,6,1,5,12,41.7,7,12,5,7,11,23,40,0,1148,DF,7.9,3,1,0,8,0,7,11,7,1,0,30,9,7,56.3
1149,"MF,DF",20.4,47,26,18,21,8,20,37,54.1,17,22,12,10,24,71,29,0,1149,"MF,DF",20.4,4,1,0,34,1,26,24,26,0,0,103,9,24,27.3
1151,DF,10.5,28,19,17,9,2,16,36,44.4,20,25,3,22,7,35,25,0,1151,DF,10.5,5,0,0,14,1,35,7,19,0,0,57,28,24,53.8
1153,MF,12.0,24,13,9,13,2,8,11,72.7,3,8,3,5,7,31,24,0,1153,MF,12.0,0,0,0,6,1,4,7,13,0,0,79,9,10,47.4
1154,"MF,DF",6.2,7,3,2,5,0,3,9,33.3,6,6,3,3,6,13,13,1,1154,"MF,DF",6.2,0,0,0,7,0,2,6,3,0,0,37,3,12,20.0
1160,MF,0.1,0,0,0,0,0,0,0,,0,0,0,0,0,0,0,0,1160,MF,0.1,0,0,0,0,0,0,0,0,0,0,0,0,0,
1161,DF,30.9,68,47,51,14,3,49,80,61.3,31,54,28,26,63,131,168,1,1161,DF,30.9,6,0,0,44,1,3,63,47,0,0,211,99,49,66.9
1163,MF,21.0,61,33,30,20,11,24,48,50.0,24,36,14,22,21,82,25,0,1163,MF,21.0,6,0,0,39,1,30,21,33,0,0,121,12,17,41.4
1164,DF,5.7,10,5,5,5,0,1,4,25.0,3,7,4,3,4,14,26,2,1164,DF,5.7,4,0,0,10,0,1,4,5,0,1,24,9,7,56.3
1165,DF,0.1,0,0,0,0,0,0,0,,0,0,0,0,0,0,1,0,1165,DF,0.1,0,0,0,0,0,0,0,0,0,0,1,0,0,
1166,DF,17.6,52,34,34,12,6,30,53,56.6,23,33,11,22,33,85,82,0,1166,DF,17.6,4,1,0,12,0,3,33,34,2,0,99,38,24,61.3
1167,MF,18.1,38,18,17,15,6,20,31,64.5,11,26,1,25,13,51,14,0,1167,MF,18.1,5,0,0,28,0,15,13,18,0,0,114,8,8,50.0
1168,DF,13.3,24,14,8,13,3,15,24,62.5,9,16,6,10,17,41,31,0,1168,DF,13.3,2,0,0,14,3,18,17,14,0,0,72,14,13,51.9
1169,MF,14.6,32,18,13,17,2,13,34,38.2,21,21,7,14,19,51,30,3,1169,MF,14.6,4,0,0,20,0,14,19,18,0,1,121,8,13,38.1
1171,DF,18.0,36,17,22,10,4,17,33,51.5,16,39,8,31,18,54,43,0,1171,DF,18.0,4,0,0,14,4,44,18,17,2,0,117,20,18,52.6
1172,MF,12.8,18,9,5,7,6,5,21,23.8,16,26,3,23,9,27,17,0,1172,MF,12.8,5,0,0,26,2,12,9,9,0,0,74,36,38,48.6
1177,DF,18.2,25,18,7,16,2,17,29,58.6,12,22,9,13,14,39,52,1,1177,DF,18.2,4,0,0,21,0,1,14,18,0,0,105,26,12,68.4
1181,MF,23.3,22,8,9,10,3,13,27,48.1,14,20,7,13,20,42,31,0,1181,MF,23.3,3,0,0,24,1,91,20,8,1,0,112,19,19,50.0
1182,"DF,MF",9.0,23,13,9,11,3,11,18,61.1,7,17,5,12,6,29,19,0,1182,"DF,MF",9.0,1,0,0,15,1,46,6,13,0,0,40,9,3,75.0
1183,DF,5.8,7,5,1,5,1,5,18,27.8,13,6,0,6,7,14,15,0,1183,DF,5.8,2,0,0,5,0,21,7,5,0,0,37,10,4,71.4
1186,MF,1.1,1,1,0,1,0,0,1,0.0,1,4,0,4,3,4,1,0,1186,MF,1.1,1,0,0,4,0,0,3,1,0,0,2,1,5,16.7
1188,MF,2.3,6,4,2,2,2,2,9,22.2,7,2,1,1,4,10,2,0,1188,MF,2.3,1,0,0,5,0,0,4,4,0,0,11,3,2,60.0
1189,MF,1.8,7,5,4,2,1,4,9,44.4,5,3,0,3,2,9,3,0,1189,MF,1.8,0,0,0,9,0,0,2,5,0,0,15,1,0,100.0
1192,MF,25.8,41,27,15,21,5,14,38,36.8,24,19,1,18,10,51,7,0,1192,MF,25.8,10,0,0,31,3,152,10,27,0,0,129,16,39,29.1
1193,DF,7.1,11,5,7,3,1,5,9,55.6,4,10,7,3,10,21,34,0,1193,DF,7.1,1,0,0,8,1,1,10,5,0,1,17,8,6,57.1
1194,DF,27.4,72,47,34,25,13,31,60,51.7,29,33,6,27,32,104,77,0,1194,DF,27.4,1,0,0,15,3,29,32,47,0,0,126,42,16,72.4
1195,DF,22.7,26,16,18,6,2,18,23,78.3,5,28,17,11,23,49,126,1,1195,DF,22.7,2,0,0,18,0,4,23,16,1,0,72,52,39,57.1
1196,MF,0.1,0,0,0,0,0,0,0,,0,0,0,0,0,0,0,0,1196,MF,0.1,0,0,0,1,0,1,0,0,0,0,2,0,1,0.0
1197,"DF,MF",17.7,34,21,17,15,2,16,26,61.5,10,32,18,14,22,56,62,0,1197,"DF,MF",17.7,9,0,0,28,0,5,22,21,0,0,78,38,30,55.9
1198,DF,24.8,19,18,13,6,0,11,26,42.3,15,29,17,12,29,48,86,2,1198,DF,24.8,1,0,0,17,2,23,29,18,0,0,125,30,38,44.1
1200,DF,0.4,0,0,0,0,0,0,0,,0,1,1,0,0,0,2,0,1200,DF,0.4,0,0,0,1,0,0,0,0,0,0,1,0,0,
1201,MF,1.6,2,0,1,0,1,2,3,66.7,1,2,0,2,1,3,0,0,1201,MF,1.6,0,0,0,0,3,10,1,0,0,0,5,0,0,
1203,DF,18.3,27,17,17,9,1,16,27,59.3,11,20,16,4,27,54,49,1,1203,DF,18.3,9,0,0,32,1,3,27,17,0,0,81,19,20,48.7
1205,MF,0.1,1,1,1,0,0,0,1,0.0,1,0,0,0,1,2,0,0,1205,MF,0.1,0,0,0,0,0,0,1,1,0,0,3,0,0,
1206,DF,2.8,4,3,4,0,0,3,3,100.0,0,7,3,4,6,10,10,0,1206,DF,2.8,0,0,0,1,1,1,6,3,0,0,9,6,4,60.0
1208,DF,2.6,7,2,4,3,0,5,9,55.6,4,3,2,1,4,11,7,0,1208,DF,2.6,0,0,0,0,0,0,4,2,0,0,14,5,2,71.4
1209,MF,0.4,0,0,0,0,0,0,1,0.0,1,1,1,0,1,1,0,0,1209,MF,0.4,0,0,0,0,0,0,1,0,0,0,3,0,0,
1210,MF,11.7,28,14,14,10,4,15,33,45.5,18,13,1,12,20,48,15,0,1210,MF,11.7,4,0,0,18,0,6,20,14,0,0,79,13,12,52.0
1212,DF,16.3,57,41,27,21,9,29,47,61.7,18,19,2,17,11,68,40,0,1212,DF,16.3,0,0,0,25,3,76,11,41,0,0,75,38,30,55.9
1214,DF,4.7,14,9,10,3,1,8,10,80.0,2,4,4,0,3,17,7,1,1214,DF,4.7,2,2,1,4,2,28,3,9,0,0,28,8,5,61.5
1215,"MF,DF",33.9,63,38,29,25,9,32,64,50.0,32,35,9,26,36,99,64,3,1215,"MF,DF",33.9,8,0,0,27,3,59,36,38,0,0,189,34,26,56.7
1217,"DF,MF",0.3,1,1,1,0,0,1,1,100.0,0,2,2,0,1,2,4,0,1217,"DF,MF",0.3,0,0,0,1,0,0,1,1,0,0,1,2,2,50.0
1220,MF,1.7,0,0,0,0,0,0,6,0.0,6,5,0,5,0,0,2,0,1220,MF,1.7,0,0,0,4,0,6,0,0,0,0,9,1,8,11.1
1222,MF,29.8,54,28,24,21,9,19,56,33.9,37,48,7,41,44,98,44,0,1222,MF,29.8,5,0,0,48,2,20,44,28,0,0,126,23,45,33.8
1223,MF,0.1,1,0,0,1,0,0,0,,0,0,0,0,0,1,1,0,1223,MF,0.1,0,0,0,1,0,1,0,0,0,0,0,0,2,0.0
1227,MF,24.5,54,32,25,22,7,26,95,27.4,69,41,6,35,23,77,25,1,1227,MF,24.5,5,0,0,28,2,113,23,32,0,0,123,5,11,31.3
1228,DF,19.4,34,24,21,11,2,14,21,66.7,7,29,17,12,26,60,94,0,1228,DF,19.4,7,1,1,26,0,0,26,24,0,1,81,48,22,68.6
1230,DF,23.5,42,19,28,12,2,23,33,69.7,10,23,12,11,23,65,67,1,1230,DF,23.5,7,0,0,28,0,0,23,19,1,0,112,47,47,50.0
1231,DF,0.8,2,1,2,0,0,2,5,40.0,3,0,0,0,0,2,4,0,1231,DF,0.8,1,0,0,2,0,1,0,1,0,0,2,0,0,
1238,DF,0.9,0,0,0,0,0,0,1,0.0,1,0,0,0,0,0,0,0,1238,DF,0.9,1,0,0,1,0,0,0,0,0,0,3,0,1,0.0
1240,MF,13.0,27,14,12,12,3,10,23,43.5,13,22,0,22,7,34,8,0,1240,MF,13.0,3,1,0,16,5,4,7,14,0,0,72,7,12,36.8
1241,MF,18.2,43,26,14,23,6,8,19,42.1,11,18,8,10,14,57,28,1,1241,MF,18.2,7,0,0,19,1,25,14,26,0,0,117,23,17,57.5
1242,MF,4.2,8,7,3,3,2,7,15,46.7,8,4,2,2,4,12,2,0,1242,MF,4.2,1,0,0,1,0,3,4,7,0,0,19,4,5,44.4
1243,"MF,DF",6.4,16,11,3,11,2,7,15,46.7,8,7,2,5,8,24,7,0,1243,"MF,DF",6.4,1,0,0,19,1,22,8,11,1,0,36,11,21,34.4
1246,MF,10.2,24,10,6,10,8,11,23,47.8,12,17,1,16,12,36,7,1,1246,MF,10.2,1,0,0,9,0,3,12,10,0,0,49,7,7,50.0
1252,MF,6.3,13,10,4,6,3,9,17,52.9,8,4,0,4,2,15,6,0,1252,MF,6.3,2,0,0,13,2,6,2,10,0,0,34,14,15,48.3
1254,DF,8.3,11,8,8,3,0,9,10,90.0,1,17,11,6,7,18,50,1,1254,DF,8.3,4,0,0,5,1,1,7,8,0,0,27,21,13,61.8
1255,DF,4.4,6,5,4,2,0,4,4,100.0,0,9,6,3,8,14,29,0,1255,DF,4.4,1,0,0,6,0,0,8,5,0,0,25,11,5,68.8
1256,DF,13.7,16,12,11,5,0,6,17,35.3,11,25,20,5,12,28,106,2,1256,DF,13.7,5,0,0,13,0,1,12,12,0,0,47,45,25,64.3
1257,DF,28.7,37,23,21,14,2,18,33,54.5,15,39,17,22,24,61,102,0,1257,DF,28.7,4,1,0,15,1,23,24,23,1,0,142,44,26,62.9
1259,MF,0.5,1,0,1,0,0,1,3,33.3,2,3,0,3,0,1,0,0,1259,MF,0.5,0,0,0,0,0,3,0,0,0,0,4,1,1,50.0
1260,MF,4.2,4,2,2,0,2,1,6,16.7,5,3,0,3,2,6,1,1,1260,MF,4.2,1,0,0,4,1,7,2,2,0,0,20,1,5,16.7
1262,DF,14.4,20,14,11,7,2,10,21,47.6,11,17,3,14,12,32,27,1,1262,DF,14.4,4,0,0,4,0,104,12,14,0,0,87,3,4,42.9
1263,DF,5.5,14,11,13,1,0,7,17,41.2,10,7,2,5,3,17,22,1,1263,DF,5.5,1,0,0,3,0,24,3,11,0,0,29,5,3,62.5
1267,DF,12.1,17,12,15,1,1,11,19,57.9,8,9,5,4,12,29,40,0,1267,DF,12.1,4,0,0,11,3,8,12,12,0,0,67,26,23,53.1
1268,MF,15.3,39,23,15,16,8,17,34,50.0,17,22,4,18,12,51,13,0,1268,MF,15.3,4,1,1,26,0,7,12,23,0,0,84,21,18,53.8
1270,DF,25.4,48,35,32,14,2,19,33,57.6,14,43,21,22,46,94,106,2,1270,DF,25.4,11,1,1,31,0,3,46,35,1,0,96,68,47,59.1
1271,DF,9.6,10,7,4,5,1,2,11,18.2,9,15,9,6,12,22,56,0,1271,DF,9.6,5,0,0,15,0,2,12,7,2,0,22,26,10,72.2
1272,DF,19.2,52,28,23,21,8,24,45,53.3,21,22,11,11,16,68,56,2,1272,DF,19.2,7,0,0,27,2,66,16,28,0,1,102,17,18,48.6
1274,"MF,DF",0.4,3,3,1,1,1,0,1,0.0,1,0,0,0,1,4,0,0,1274,"MF,DF",0.4,0,0,0,2,1,1,1,3,0,0,5,1,2,33.3
1278,DF,5.8,7,4,6,0,1,3,6,50.0,3,9,7,2,3,10,29,1,1278,DF,5.8,2,0,0,7,0,1,3,4,1,0,14,11,11,50.0
1284,DF,10.8,23,17,13,8,2,12,22,54.5,10,18,2,16,5,28,30,0,1284,DF,10.8,0,0,0,18,0,21,5,17,0,0,60,10,11,47.6
1285,DF,4.2,5,1,2,3,0,1,2,50.0,1,4,3,1,1,6,12,1,1285,DF,4.2,0,0,0,1,0,5,1,1,0,0,15,3,8,27.3
1286,MF,17.2,53,36,22,22,9,28,52,53.8,24,24,5,19,18,71,7,0,1286,MF,17.2,3,0,0,39,2,11,18,36,0,0,75,3,16,15.8
1288,MF,18.4,43,29,16,21,6,24,47,51.1,23,21,7,14,21,64,16,0,1288,MF,18.4,7,1,0,35,0,2,21,29,0,0,97,19,25,43.2
1289,DF,24.7,45,32,26,13,6,25,38,65.8,13,29,2,27,26,71,66,0,1289,DF,24.7,4,0,0,21,6,71,26,32,0,0,130,16,14,53.3
1290,DF,3.7,3,1,1,2,0,1,3,33.3,2,6,3,3,4,7,14,1,1290,DF,3.7,1,0,0,4,0,0,4,1,0,0,12,6,2,75.0
1293,MF,15.1,19,8,8,9,2,10,21,47.6,11,19,7,12,11,30,14,1,1293,MF,15.1,3,0,0,16,0,11,11,8,1,0,102,3,10,23.1
1298,MF,29.1,72,44,23,38,11,29,60,48.3,31,37,8,29,27,99,43,0,1298,MF,29.1,9,0,0,28,0,4,27,44,0,0,174,44,38,53.7
1299,MF,9.9,18,14,9,9,0,12,19,63.2,7,19,2,17,6,24,9,1,1299,MF,9.9,1,0,0,10,0,1,6,14,0,0,50,2,7,22.2
1300,DF,19.8,45,27,23,14,8,21,33,63.6,12,42,11,31,13,58,43,0,1300,DF,19.8,4,0,0,17,5,52,13,27,0,0,76,21,16,56.8
1304,DF,13.2,25,18,11,8,6,16,24,66.7,8,13,4,9,9,34,16,0,1304,DF,13.2,2,0,0,9,0,28,9,18,0,0,50,5,2,71.4
1305,"MF,DF",16.4,23,14,8,9,6,9,20,45.0,11,13,4,9,8,31,9,0,1305,"MF,DF",16.4,5,0,0,18,3,38,8,14,0,0,85,24,36,40.0
1307,DF,11.6,26,20,16,8,2,16,25,64.0,9,20,4,16,8,34,18,0,1307,DF,11.6,4,0,0,19,2,45,8,20,1,0,58,11,15,42.3
1309,DF,22.9,53,30,27,15,11,35,48,72.9,13,25,12,13,18,71,46,2,1309,DF,22.9,2,0,0,14,2,66,18,30,0,0,105,17,18,48.6
1311,DF,4.9,7,3,3,3,1,1,7,14.3,6,5,4,1,5,12,18,1,1311,DF,4.9,2,0,0,5,0,0,5,3,1,0,26,16,11,59.3
1312,MF,0.1,1,1,0,1,0,0,0,,0,1,0,1,1,2,0,0,1312,MF,0.1,1,0,0,1,0,0,1,1,0,0,5,3,2,60.0
1313,DF,5.8,4,2,4,0,0,3,6,50.0,3,7,0,7,8,12,17,0,1313,DF,5.8,1,0,0,10,0,3,8,2,0,0,32,6,9,40.0
1314,MF,20.5,46,24,24,19,3,31,73,42.5,42,20,3,17,23,69,16,1,1314,MF,20.5,4,0,0,30,0,19,23,24,0,0,115,9,31,22.5
1315,"DF,MF",0.2,1,1,0,1,0,0,0,,0,2,2,0,0,1,0,0,1315,"DF,MF",0.2,2,0,0,2,0,0,0,1,0,0,0,1,2,33.3
1316,DF,14.7,32,22,22,7,3,22,39,56.4,17,18,6,12,30,62,55,0,1316,DF,14.7,4,1,1,17,0,4,30,22,1,0,61,22,20,52.4
1317,MF,14.2,34,19,14,15,5,17,28,60.7,11,27,10,17,29,63,30,0,1317,MF,14.2,4,0,0,23,0,4,29,19,0,0,83,7,11,38.9
1318,"MF,DF",1.2,1,1,1,0,0,0,1,0.0,1,2,0,2,2,3,1,0,1318,"MF,DF",1.2,2,0,0,2,0,0,2,1,0,0,14,0,3,0.0
1319,"DF,MF",10.2,20,15,14,5,1,10,15,66.7,5,17,8,9,12,32,44,3,1319,"DF,MF",10.2,0,0,0,12,0,2,12,15,0,0,52,23,17,57.5
1322,DF,17.3,24,19,10,9,5,14,25,56.0,11,22,12,10,13,37,67,0,1322,DF,17.3,2,0,0,17,0,21,13,19,1,0,121,28,18,60.9
1324,MF,0.3,0,0,0,0,0,0,3,0.0,3,1,0,1,0,0,0,0,1324,MF,0.3,0,0,0,2,0,0,0,0,0,0,2,0,2,0.0
1325,MF,15.0,20,13,9,8,3,8,24,33.3,16,16,4,12,9,29,12,0,1325,MF,15.0,1,0,0,14,0,81,9,13,0,0,65,13,20,39.4
1326,DF,21.9,47,26,31,13,3,30,42,71.4,12,31,11,20,20,67,60,2,1326,DF,21.9,4,1,0,25,1,55,20,26,0,1,93,18,31,36.7
1327,"MF,DF",0.1,0,0,0,0,0,0,0,,0,0,0,0,0,0,0,0,1327,"MF,DF",0.1,0,0,0,0,0,0,0,0,0,0,0,0,1,0.0
1330,MF,14.9,35,22,15,19,1,17,26,65.4,9,12,5,7,22,57,38,0,1330,MF,14.9,5,1,0,25,1,6,22,22,1,0,74,19,18,51.4
1331,DF,9.0,21,12,13,8,0,9,17,52.9,8,13,8,5,13,34,32,2,1331,DF,9.0,5,0,0,9,0,2,13,12,1,0,41,6,5,54.5
1333,DF,7.1,16,9,15,1,0,9,14,64.3,5,12,5,7,7,23,28,0,1333,DF,7.1,1,0,0,4,0,1,7,9,0,0,24,10,7,58.8
1334,DF,38.0,47,21,40,6,1,24,32,75.0,8,64,37,27,39,86,182,4,1334,DF,38.0,7,0,0,38,2,6,39,21,1,0,177,86,36,70.5
1335,"MF,DF",24.2,45,33,25,15,5,26,39,66.7,13,32,4,28,14,59,28,1,1335,"MF,DF",24.2,1,1,0,11,2,195,14,33,0,0,140,5,14,26.3
1336,DF,10.5,20,12,11,8,1,14,19,73.7,5,11,3,8,8,28,28,1,1336,DF,10.5,1,0,0,10,0,12,8,12,0,0,35,15,11,57.7
1337,DF,13.0,24,15,11,11,2,14,22,63.6,8,22,16,6,14,38,46,2,1337,DF,13.0,1,0,0,9,0,1,14,15,0,0,59,23,17,57.5
1338,MF,2.3,4,2,0,4,0,1,3,33.3,2,5,1,4,3,7,4,0,1338,MF,2.3,1,0,0,3,1,0,3,2,0,0,9,4,1,80.0
1339,DF,26.2,37,22,30,4,3,24,36,66.7,12,31,20,11,21,58,94,1,1339,DF,26.2,9,0,0,29,4,8,21,22,0,0,87,42,38,52.5
1341,DF,16.0,15,10,7,7,1,4,13,30.8,9,25,12,13,13,28,64,1,1341,DF,16.0,3,0,0,11,1,8,13,10,0,0,81,16,32,33.3
1343,"MF,DF",23.4,43,26,17,16,10,17,31,54.8,14,40,3,37,20,63,15,0,1343,"MF,DF",23.4,7,1,1,32,2,46,20,26,3,0,92,23,43,34.8
1344,DF,21.3,34,22,27,7,0,19,30,63.3,11,27,19,8,13,47,73,0,1344,DF,21.3,1,0,0,10,0,3,13,22,1,1,152,46,41,52.9
1346,DF,30.4,38,23,26,12,0,17,27,63.0,10,33,24,9,32,70,136,2,1346,DF,30.4,10,0,0,20,0,4,32,23,2,0,138,80,50,61.5
1348,"DF,MF",24.3,65,42,36,25,4,36,57,63.2,21,27,6,21,43,108,58,0,1348,"DF,MF",24.3,15,1,1,48,0,22,43,42,0,0,134,42,41,50.6
1349,MF,27.7,66,44,27,32,7,36,79,45.6,43,37,12,25,16,82,34,1,1349,MF,27.7,5,0,0,19,0,11,16,44,0,0,198,15,16,48.4
1350,DF,24.2,44,32,23,19,2,30,49,61.2,19,22,9,13,21,65,47,0,1350,DF,24.2,4,0,0,29,1,9,21,32,0,0,151,34,32,51.5
1354,"MF,DF",1.3,3,3,3,0,0,3,5,60.0,2,0,0,0,0,3,1,0,1354,"MF,DF",1.3,0,0,0,2,0,1,0,3,0,0,3,0,1,0.0
1355,DF,11.9,26,15,17,9,0,20,36,55.6,16,16,2,14,13,39,21,0,1355,DF,11.9,4,0,0,17,0,43,13,15,1,0,55,7,12,36.8
1356,DF,17.5,36,22,22,13,1,18,24,75.0,6,18,12,6,20,56,51,1,1356,DF,17.5,5,1,1,25,0,1,20,22,0,0,97,77,31,71.3
1357,MF,16.3,48,31,18,25,5,13,32,40.6,19,21,4,17,30,78,25,0,1357,MF,16.3,3,0,0,25,2,2,30,31,0,0,114,17,7,70.8
1358,DF,2.1,7,7,5,2,0,4,11,36.4,7,2,0,2,2,9,9,0,1358,DF,2.1,1,0,0,2,0,1,2,7,0,0,14,0,1,0.0
1359,MF,5.3,13,8,11,2,0,6,10,60.0,4,8,3,5,10,23,10,0,1359,MF,5.3,4,1,1,7,0,1,10,8,0,0,42,12,12,50.0
1362,MF,17.3,45,26,20,20,5,17,25,68.0,8,22,1,21,15,60,16,1,1362,MF,17.3,4,1,0,28,3,3,15,26,1,0,111,21,24,46.7
1363,DF,34.1,54,32,28,23,3,23,27,85.2,4,36,20,16,28,82,73,3,1363,DF,34.1,5,0,0,14,0,17,28,32,1,0,142,30,14,68.2
1364,MF,29.2,39,24,12,22,5,17,50,34.0,33,33,3,30,10,49,35,0,1364,MF,29.2,5,0,0,53,5,121,10,24,1,0,150,29,34,46.0
1365,DF,20.1,30,20,11,12,7,15,26,57.7,11,27,3,24,27,57,43,1,1365,DF,20.1,3,0,0,17,0,2,27,20,0,0,132,23,17,57.5
1366,DF,20.2,37,23,20,13,4,17,33,51.5,16,29,8,21,9,46,43,0,1366,DF,20.2,2,0,0,19,7,168,9,23,0,0,73,11,17,39.3
1369,MF,9.1,14,9,6,7,1,7,15,46.7,8,10,2,8,13,27,10,1,1369,MF,9.1,2,0,0,11,1,1,13,9,0,0,60,19,13,59.4
1370,DF,9.6,20,13,12,7,1,11,17,64.7,6,9,6,3,13,33,38,1,1370,DF,9.6,2,0,0,16,1,16,13,13,0,0,52,13,6,68.4
1372,DF,3.5,2,2,1,1,0,0,2,0.0,2,4,3,1,4,6,9,0,1372,DF,3.5,3,0,0,9,0,14,4,2,3,0,20,1,7,12.5
1373,DF,32.2,37,23,22,10,5,28,51,54.9,23,32,12,20,25,62,83,5,1373,DF,32.2,4,0,0,22,2,34,25,23,0,0,157,71,44,61.7
1374,DF,21.4,49,30,39,8,2,28,51,54.9,23,31,20,11,29,78,123,1,1374,DF,21.4,5,1,0,35,1,1,29,30,2,0,110,61,28,68.5
1375,MF,2.4,8,5,3,3,2,1,4,25.0,3,4,1,3,2,10,10,0,1375,MF,2.4,2,0,0,6,0,0,2,5,0,0,14,10,10,50.0
1376,MF,17.2,36,25,16,15,5,18,28,64.3,10,23,1,22,10,46,10,0,1376,MF,17.2,4,0,0,17,0,0,10,25,0,0,72,4,4,50.0
1377,MF,6.8,5,2,2,2,1,2,8,25.0,6,12,2,10,1,6,7,0,1377,MF,6.8,1,0,0,7,2,13,1,2,0,0,23,8,14,36.4
1380,DF,10.1,21,14,10,7,4,12,25,48.0,13,8,3,5,9,30,21,0,1380,DF,10.1,2,0,0,10,0,17,9,14,0,0,44,13,15,46.4
1381,MF,15.2,19,14,7,10,2,8,20,40.0,12,15,4,11,11,30,30,0,1381,MF,15.2,2,0,0,16,2,17,11,14,0,0,85,16,17,48.5
1383,MF,2.8,10,5,5,5,0,2,14,14.3,12,7,1,6,4,14,6,0,1383,MF,2.8,4,0,0,6,0,3,4,5,0,0,20,7,7,50.0
1384,DF,0.6,2,0,2,0,0,1,2,50.0,1,0,0,0,0,2,0,0,1384,DF,0.6,0,0,0,0,1,0,0,0,0,0,4,0,0,
1385,MF,15.0,57,33,22,31,4,21,58,36.2,37,33,4,29,17,74,28,0,1385,MF,15.0,5,0,0,31,0,7,17,33,0,0,148,15,11,57.7
1386,DF,19.4,36,19,25,8,3,28,50,56.0,22,27,7,20,8,44,50,0,1386,DF,19.4,5,0,0,14,1,44,8,19,0,1,67,30,21,58.8
1387,DF,23.3,35,24,25,10,0,21,33,63.6,12,29,20,9,29,64,118,0,1387,DF,23.3,4,1,1,26,1,1,29,24,0,0,74,58,40,59.2
1388,MF,23.6,53,34,19,25,9,24,59,40.7,35,22,4,18,17,70,11,1,1388,MF,23.6,3,0,0,17,3,118,17,34,0,0,144,8,4,66.7
1390,MF,7.6,10,8,3,6,1,4,9,44.4,5,7,3,4,11,21,14,0,1390,MF,7.6,3,0,0,10,0,4,11,8,0,0,41,11,6,64.7
1391,DF,20.5,50,24,35,13,2,26,42,61.9,16,36,14,22,37,87,57,1,1391,DF,20.5,7,0,0,19,3,21,37,24,0,0,113,35,25,58.3
1393,MF,0.0,0,0,0,0,0,0,0,,0,0,0,0,0,0,0,0,1393,MF,0.0,0,0,0,0,0,0,0,0,0,0,0,0,0,
1395,MF,0.1,0,0,0,0,0,0,0,,0,0,0,0,0,0,0,0,1395,MF,0.1,0,0,0,0,0,0,0,0,0,0,1,0,2,0.0
1397,DF,10.3,30,20,14,12,4,9,22,40.9,13,12,3,9,14,44,18,2,1397,DF,10.3,3,0,0,23,2,28,14,20,0,0,60,4,9,30.8
1398,DF,4.0,3,2,2,1,0,1,2,50.0,1,8,6,2,0,3,22,0,1398,DF,4.0,1,0,0,3,0,0,0,2,1,1,6,4,4,50.0
1400,DF,0.1,0,0,0,0,0,0,0,,0,0,0,0,0,0,0,0,1400,DF,0.1,0,0,0,0,0,0,0,0,0,0,0,0,0,
1401,MF,2.2,6,4,5,1,0,3,6,50.0,3,3,0,3,4,10,5,0,1401,MF,2.2,0,0,0,4,0,12,4,4,0,0,6,2,2,50.0
1402,MF,23.2,34,19,11,13,10,15,43,34.9,28,18,5,13,22,56,18,1,1402,MF,23.2,1,0,0,30,4,27,22,19,0,0,110,26,20,56.5
1407,DF,19.0,19,10,16,3,0,11,24,45.8,13,18,1,17,13,32,28,0,1407,DF,19.0,3,0,0,15,2,84,13,10,1,0,71,12,20,37.5
1408,MF,21.7,39,21,12,22,5,22,43,51.2,21,23,4,19,12,51,17,0,1408,MF,21.7,4,1,1,40,4,17,12,21,0,0,107,14,37,27.5
1411,DF,26.2,48,29,28,18,2,29,41,70.7,12,35,12,23,24,72,121,0,1411,DF,26.2,5,3,1,27,0,5,24,29,0,0,126,64,50,56.1
1413,DF,1.0,2,0,2,0,0,0,0,,0,1,0,1,0,2,2,0,1413,DF,1.0,0,0,0,1,0,0,0,0,0,0,2,0,0,
1414,MF,11.9,21,12,4,12,5,4,12,33.3,8,26,2,24,12,33,14,2,1414,MF,11.9,2,0,0,20,0,22,12,12,0,0,80,12,14,46.2
1415,"DF,MF",19.7,56,36,25,20,11,22,52,42.3,30,42,6,36,18,74,13,2,1415,"DF,MF",19.7,3,0,0,28,2,31,18,36,0,0,114,12,19,38.7
1416,"DF,MF",8.3,23,16,15,8,0,14,24,58.3,10,13,6,7,5,28,28,0,1416,"DF,MF",8.3,2,0,0,8,1,19,5,16,0,0,33,7,12,36.8
1417,DF,33.0,78,51,39,28,11,30,56,53.6,26,27,6,21,28,106,75,1,1417,DF,33.0,7,0,0,24,0,143,28,51,0,0,221,7,14,33.3
1424,DF,9.1,17,12,10,5,2,6,14,42.9,8,11,4,7,4,21,33,2,1424,DF,9.1,1,1,0,4,0,16,4,12,0,0,37,2,6,25.0
1426,DF,0.1,0,0,0,0,0,0,0,,0,1,1,0,0,0,1,0,1426,DF,0.1,0,0,0,0,0,0,0,0,0,0,2,0,0,
1427,DF,20.2,23,14,15,7,1,16,36,44.4,20,36,26,10,11,34,116,1,1427,DF,20.2,4,0,0,20,1,1,11,14,1,0,73,38,34,52.8
1429,DF,5.9,17,9,10,5,2,10,14,71.4,4,6,1,5,7,24,20,1,1429,DF,5.9,1,0,0,5,1,6,7,9,0,0,34,1,4,20.0
1430,MF,21.0,32,18,18,10,4,15,28,53.6,13,34,7,27,29,61,30,1,1430,MF,21.0,1,0,0,16,1,8,29,18,0,0,116,9,19,32.1
1431,DF,12.0,14,9,7,7,0,6,11,54.5,5,17,12,5,5,19,42,0,1431,DF,12.0,4,0,0,17,1,1,5,9,0,0,53,47,24,66.2
1433,DF,17.2,38,23,19,13,6,16,27,59.3,11,17,3,14,17,55,27,0,1433,DF,17.2,3,0,0,19,2,49,17,23,0,0,83,10,19,34.5
1435,MF,0.4,1,0,0,1,0,0,0,,0,0,0,0,0,1,1,0,1435,MF,0.4,0,0,0,1,0,0,0,0,0,0,0,0,0,
1437,"DF,MF",22.2,18,11,7,9,2,13,19,68.4,6,14,1,13,8,26,29,0,1437,"DF,MF",22.2,3,0,0,12,1,127,8,11,0,0,103,14,20,41.2
1439,DF,18.6,26,18,13,10,3,18,28,64.3,10,20,4,16,12,38,37,1,1439,DF,18.6,4,1,0,16,1,56,12,18,0,0,72,5,16,23.8
1440,"DF,MF",16.8,35,22,25,7,3,19,40,47.5,21,24,3,21,12,47,42,0,1440,"DF,MF",16.8,2,0,0,7,0,33,12,22,0,0,61,7,11,38.9
1441,DF,5.3,19,11,11,7,1,8,12,66.7,4,6,3,3,13,32,26,0,1441,DF,5.3,3,0,0,7,0,5,13,11,0,0,20,11,9,55.0
1442,DF,0.6,6,2,4,2,0,4,9,44.4,5,2,1,1,0,6,0,0,1442,DF,0.6,0,0,0,2,0,4,0,2,0,0,6,1,0,100.0
1444,MF,17.0,50,35,23,17,10,23,47,48.9,24,17,3,14,19,69,20,0,1444,MF,17.0,3,0,0,24,0,24,19,35,0,0,127,11,12,47.8
1445,"DF,MF",6.0,5,0,4,0,1,4,8,50.0,4,11,3,8,3,8,10,0,1445,"DF,MF",6.0,1,0,0,3,2,18,3,0,0,0,35,2,2,50.0
1446,DF,27.4,31,22,16,15,0,17,30,56.7,13,26,15,11,28,59,96,1,1446,DF,27.4,13,0,0,33,1,1,28,22,1,1,111,110,60,64.7
1453,MF,28.0,96,67,51,41,4,49,129,38.0,80,61,11,50,43,139,64,3,1453,MF,28.0,12,1,1,47,1,31,43,67,0,0,270,20,12,62.5
1454,DF,30.0,52,36,31,15,6,25,51,49.0,26,48,22,26,47,99,155,1,1454,DF,30.0,6,0,0,40,1,4,47,36,2,0,145,71,44,61.7
1455,DF,4.2,6,3,5,1,0,3,6,50.0,3,2,0,2,4,10,13,0,1455,DF,4.2,0,0,0,2,0,0,4,3,0,0,28,13,6,68.4
1456,DF,37.0,39,25,26,11,2,19,30,63.3,11,33,18,15,23,62,155,1,1456,DF,37.0,5,0,0,26,3,7,23,25,0,1,173,80,49,62.0
1457,DF,0.3,0,0,0,0,0,0,0,,0,1,1,0,0,0,1,0,1457,DF,0.3,0,0,0,0,0,0,0,0,0,0,0,0,0,
1458,DF,22.2,40,22,25,10,5,27,53,50.9,26,24,6,18,15,55,50,0,1458,DF,22.2,4,0,0,15,0,37,15,22,0,0,139,15,9,62.5
1459,MF,1.8,3,1,2,1,0,1,2,50.0,1,0,0,0,0,3,0,0,1459,MF,1.8,0,0,0,3,0,6,0,1,0,0,5,0,2,0.0
1460,MF,33.0,90,58,46,33,11,25,47,53.2,22,36,9,27,41,131,64,0,1460,MF,33.0,12,1,1,43,8,15,41,58,0,0,199,35,41,46.1
1461,DF,2.8,4,1,1,3,0,0,2,0.0,2,3,1,2,2,6,4,0,1461,DF,2.8,1,0,0,2,1,5,2,1,0,0,10,5,2,71.4
1462,DF,0.1,2,2,0,2,0,1,1,100.0,0,0,0,0,0,2,1,0,1462,DF,0.1,0,0,0,0,0,0,0,2,0,0,1,0,0,
1463,DF,12.8,13,9,7,5,1,7,13,53.8,6,19,11,8,7,20,47,1,1463,DF,12.8,3,0,0,3,0,3,7,9,0,0,37,15,11,57.7
1465,"DF,MF",0.5,2,1,2,0,0,1,1,100.0,0,0,0,0,2,4,2,0,1465,"DF,MF",0.5,0,0,0,2,0,5,2,1,0,0,3,2,1,66.7
1466,DF,0.1,1,1,0,1,0,1,1,100.0,0,0,0,0,0,1,1,0,1466,DF,0.1,0,0,0,0,0,0,0,1,0,0,1,0,0,
1467,MF,2.8,4,3,2,2,0,1,8,12.5,7,5,0,5,4,8,0,0,1467,MF,2.8,1,0,0,6,0,2,4,3,0,0,22,1,2,33.3
1468,"MF,DF",26.7,42,25,15,23,4,19,40,47.5,21,31,12,19,36,78,72,0,1468,"MF,DF",26.7,8,0,0,43,4,14,36,25,0,0,174,69,33,67.6
1469,MF,5.5,19,10,8,8,3,6,21,28.6,15,12,3,9,7,26,8,0,1469,MF,5.5,4,0,0,19,0,1,7,10,0,0,37,8,9,47.1
1472,"DF,MF",9.0,10,7,4,4,2,3,7,42.9,4,7,1,6,4,14,6,0,1472,"DF,MF",9.0,1,0,0,7,0,1,4,7,0,0,42,0,6,0.0
1474,DF,14.1,20,13,14,5,1,13,23,56.5,10,18,11,7,14,34,51,0,1474,DF,14.1,3,0,0,12,1,4,14,13,1,0,77,33,14,70.2
1475,DF,15.4,15,12,4,8,3,6,11,54.5,5,14,10,4,19,34,52,0,1475,DF,15.4,5,0,0,12,0,2,19,12,0,0,73,41,28,59.4
1476,DF,14.8,15,10,8,7,0,5,13,38.5,8,18,9,9,12,27,40,1,1476,DF,14.8,2,0,0,15,3,1,12,10,0,0,75,17,24,41.5
1479,MF,20.6,30,21,9,20,1,9,29,31.0,20,24,8,16,23,53,27,1,1479,MF,20.6,12,0,0,50,2,19,23,21,0,0,102,18,16,52.9
1480,"DF,MF",23.1,61,34,32,17,12,35,70,50.0,35,37,1,36,14,75,27,0,1480,"DF,MF",23.1,1,0,0,26,9,41,14,34,0,0,144,9,17,34.6
1481,MF,4.3,9,7,4,3,2,3,11,27.3,8,9,2,7,6,15,7,0,1481,MF,4.3,0,0,0,6,0,5,6,7,0,0,22,5,7,41.7
1482,DF,17.1,30,18,14,15,1,17,35,48.6,18,12,1,11,19,49,41,1,1482,DF,17.1,1,0,0,7,2,25,19,18,0,0,80,14,19,42.4
1484,DF,14.6,23,13,15,6,2,10,21,47.6,11,16,7,9,25,48,41,1,1484,DF,14.6,1,0,0,3,1,26,25,13,0,0,85,12,8,60.0
1487,DF,24.1,31,19,20,10,1,11,24,45.8,13,40,27,13,22,53,79,0,1487,DF,24.1,5,0,0,25,0,6,22,19,1,0,92,43,50,46.2
1488,"MF,DF",28.5,40,23,18,17,5,16,44,36.4,28,36,11,25,14,54,35,0,1488,"MF,DF",28.5,5,0,0,31,19,70,14,23,0,0,115,16,32,33.3
1489,DF,30.9,50,28,40,9,1,28,42,66.7,14,50,30,20,32,82,142,1,1489,DF,30.9,2,0,0,35,1,3,32,28,2,0,147,75,36,67.6
1490,"MF,DF",2.2,3,1,2,1,0,1,4,25.0,3,5,2,3,4,7,8,0,1490,"MF,DF",2.2,0,1,0,3,0,0,4,1,0,0,10,2,2,50.0
1491,MF,5.6,22,13,10,8,4,9,14,64.3,5,4,1,3,5,27,2,0,1491,MF,5.6,2,0,0,12,1,13,5,13,1,0,46,1,5,16.7
1492,MF,36.5,61,39,18,30,13,24,60,40.0,36,30,8,22,30,91,29,0,1492,MF,36.5,4,0,0,33,0,3,30,39,0,0,236,11,23,32.4
1493,MF,33.4,69,43,24,35,10,31,58,53.4,27,43,17,26,25,94,65,0,1493,MF,33.4,6,0,0,41,2,10,25,43,0,0,171,26,15,63.4
1494,DF,32.9,97,55,57,34,6,47,80,58.8,33,28,1,27,40,137,69,0,1494,DF,32.9,5,0,0,26,1,94,40,55,0,0,213,30,25,54.5
1495,DF,13.0,25,16,17,6,2,15,22,68.2,7,23,13,10,23,48,68,0,1495,DF,13.0,4,0,0,15,0,1,23,16,1,1,89,31,16,66.0
1496,DF,13.7,24,16,8,13,3,13,21,61.9,8,7,2,5,16,40,35,0,1496,DF,13.7,6,0,0,27,1,70,16,16,0,0,68,7,11,38.9
1497,MF,23.0,28,18,7,14,7,15,27,55.6,12,24,12,12,9,37,10,1,1497,MF,23.0,5,0,0,39,1,13,9,18,0,0,91,43,31,58.1
1499,MF,19.9,62,35,15,34,13,20,42,47.6,22,20,2,18,12,74,16,1,1499,MF,19.9,2,0,0,32,1,23,12,35,0,0,123,27,27,50.0
1500,MF,30.5,54,30,17,29,8,24,63,38.1,39,43,7,36,17,71,23,0,1500,MF,30.5,7,0,0,24,2,25,17,30,0,0,120,18,22,45.0
1502,DF,3.8,10,7,6,4,0,7,14,50.0,7,7,1,6,7,17,18,0,1502,DF,3.8,1,0,0,4,0,2,7,7,0,0,27,5,7,41.7
1504,DF,21.8,33,20,21,12,0,17,22,77.3,5,28,19,9,20,53,63,4,1504,DF,21.8,4,0,0,17,1,0,20,20,1,0,121,32,38,45.7
1507,DF,26.5,23,12,11,9,3,15,26,57.7,11,25,9,16,10,33,77,1,1507,DF,26.5,3,0,0,25,1,105,10,12,1,0,123,28,22,56.0
1508,MF,8.9,18,9,5,10,3,6,12,50.0,6,3,1,2,7,25,6,0,1508,MF,8.9,1,0,0,8,0,16,7,9,0,0,46,3,5,37.5
1509,MF,1.6,2,1,1,1,0,1,2,50.0,1,1,1,0,2,4,0,0,1509,MF,1.6,0,1,0,2,0,0,2,1,0,0,10,0,1,0.0
1511,MF,23.4,48,24,18,23,7,21,53,39.6,32,24,3,21,16,64,15,2,1511,MF,23.4,8,0,0,60,3,73,16,24,0,0,160,16,19,45.7
1512,MF,21.3,62,37,36,20,6,17,44,38.6,27,23,5,18,15,77,22,2,1512,MF,21.3,5,0,0,30,0,7,15,37,0,0,149,31,12,72.1
1513,MF,28.6,63,37,15,40,8,23,51,45.1,28,37,8,29,25,88,51,0,1513,MF,28.6,10,0,0,38,5,6,25,37,0,0,136,82,54,60.3
1514,DF,20.0,36,28,18,9,9,25,35,71.4,10,30,9,21,16,52,26,1,1514,DF,20.0,4,0,0,12,0,20,16,28,1,0,72,21,15,58.3
1515,"MF,DF",4.5,14,5,6,6,2,7,11,63.6,4,7,3,4,3,17,9,0,1515,"MF,DF",4.5,1,0,0,7,0,33,3,5,0,0,13,4,8,33.3
1516,MF,9.6,13,7,2,8,3,2,8,25.0,6,8,1,7,9,22,4,0,1516,MF,9.6,1,0,0,16,0,53,9,7,0,0,57,9,8,52.9
1517,DF,6.0,10,7,5,5,0,4,5,80.0,1,9,5,4,13,23,10,0,1517,DF,6.0,2,0,0,14,0,0,13,7,1,0,18,11,9,55.0
1518,DF,10.5,27,14,17,8,2,16,24,66.7,8,14,7,7,18,45,41,1,1518,DF,10.5,2,0,0,7,0,1,18,14,2,0,47,15,18,45.5
1519,DF,8.0,9,7,6,3,0,3,7,42.9,4,6,5,1,12,21,37,0,1519,DF,8.0,2,1,0,12,0,3,12,7,0,0,33,24,10,70.6
1520,MF,22.1,25,12,9,11,5,9,23,39.1,14,21,2,19,21,46,24,0,1520,MF,22.1,1,1,0,25,1,82,21,12,0,0,118,8,18,30.8
1521,"DF,MF",5.6,21,10,13,5,3,8,15,53.3,7,10,4,6,5,26,15,0,1521,"DF,MF",5.6,1,0,0,7,1,8,5,10,0,0,7,5,11,31.3
1524,DF,17.1,47,27,32,11,4,32,55,58.2,23,27,4,23,17,64,45,0,1524,DF,17.1,6,0,0,12,2,72,17,27,0,0,92,11,23,32.4
1526,DF,24.6,48,29,31,17,0,27,36,75.0,9,32,17,15,16,64,68,2,1526,DF,24.6,1,0,0,10,1,1,16,29,0,0,136,29,28,50.9
1527,DF,19.9,71,36,44,23,4,43,67,64.2,24,18,3,15,11,82,42,0,1527,DF,19.9,2,0,0,24,1,82,11,36,0,0,112,11,9,55.0
1529,DF,0.3,2,1,1,1,0,1,1,100.0,0,2,1,1,1,3,6,0,1529,DF,0.3,0,0,0,0,0,0,1,1,0,0,3,3,0,100.0
1530,MF,33.3,58,38,21,27,10,25,53,47.2,28,32,8,24,23,81,18,2,1530,MF,33.3,12,0,0,51,0,115,23,38,0,0,184,25,18,58.1
1532,DF,24.3,19,12,10,9,0,10,12,83.3,2,35,13,22,12,31,94,2,1532,DF,24.3,3,0,0,8,1,5,12,12,0,0,158,32,27,54.2
1534,MF,12.5,33,19,9,17,7,18,39,46.2,21,18,5,13,16,49,19,1,1534,MF,12.5,3,0,0,27,0,4,16,19,0,0,65,11,8,57.9
1535,MF,0.2,0,0,0,0,0,0,0,,0,1,0,1,1,1,0,0,1535,MF,0.2,0,0,0,0,0,0,1,0,0,0,2,0,1,0.0
1537,DF,37.8,37,26,25,10,2,15,24,62.5,9,46,35,11,32,69,157,1,1537,DF,37.8,4,0,0,26,1,12,32,26,0,0,142,77,58,57.0
1538,DF,2.4,2,1,1,1,0,1,3,33.3,2,4,2,2,4,6,8,0,1538,DF,2.4,1,0,0,2,0,1,4,1,1,0,7,3,1,75.0
1541,DF,10.0,10,6,5,4,1,5,10,50.0,5,15,5,10,5,15,30,0,1541,DF,10.0,2,0,0,12,2,59,5,6,0,0,31,16,13,55.2
1542,MF,20.0,64,38,33,27,4,30,70,42.9,40,41,8,33,41,105,56,0,1542,MF,20.0,6,0,0,35,0,4,41,38,0,0,118,12,29,29.3
1543,MF,0.2,0,0,0,0,0,0,0,,0,0,0,0,0,0,0,0,1543,MF,0.2,1,0,0,1,0,0,0,0,0,0,1,1,0,100.0
1546,DF,14.0,30,22,15,9,6,16,30,53.3,14,22,4,18,13,43,26,0,1546,DF,14.0,5,0,0,19,0,26,13,22,0,0,79,2,9,18.2
1547,MF,28.9,99,55,35,50,14,59,125,47.2,66,65,8,57,35,134,25,1,1547,MF,28.9,7,1,0,53,0,32,35,55,0,0,195,31,28,52.5
1548,DF,12.5,24,18,10,10,4,15,20,75.0,5,13,2,11,7,31,8,0,1548,DF,12.5,4,0,0,30,2,29,7,18,0,0,61,12,10,54.5
1549,MF,8.7,23,14,7,9,7,13,24,54.2,11,8,1,7,4,27,2,0,1549,MF,8.7,0,1,0,12,2,64,4,14,0,0,53,3,10,23.1
1550,MF,23.7,33,19,5,18,10,15,29,51.7,14,15,3,12,13,46,10,1,1550,MF,23.7,5,0,0,21,2,133,13,19,0,0,60,3,6,33.3
1552,DF,16.2,35,22,18,13,4,23,40,57.5,17,12,2,10,10,45,23,0,1552,DF,16.2,3,1,0,22,4,67,10,22,0,0,81,33,25,56.9
1553,DF,33.8,48,28,24,22,2,17,22,77.3,5,44,33,11,31,79,100,1,1553,DF,33.8,4,0,0,35,1,4,31,28,0,1,136,77,62,55.4
1554,"DF,MF",15.0,56,26,22,32,2,26,48,54.2,22,21,4,17,21,77,36,2,1554,"DF,MF",15.0,7,0,0,31,1,3,21,26,1,0,112,24,17,58.5
1555,MF,20.0,49,29,26,22,1,20,42,47.6,22,27,5,22,24,73,38,0,1555,MF,20.0,9,1,1,39,1,3,24,29,1,0,134,24,46,34.3
1556,DF,18.9,35,21,25,10,0,22,36,61.1,14,29,11,18,22,57,92,5,1556,DF,18.9,7,2,0,31,1,7,22,21,1,0,85,51,24,68.0
1557,DF,27.2,33,18,23,10,0,15,25,60.0,10,50,28,22,45,78,118,0,1557,DF,27.2,6,0,0,27,0,12,45,18,0,0,147,45,37,54.9
1558,MF,26.0,49,27,18,26,5,24,58,41.4,34,19,1,18,18,67,18,0,1558,MF,26.0,6,0,0,21,2,20,18,27,0,0,156,13,23,36.1
1559,MF,18.7,49,31,12,32,5,22,47,46.8,25,38,13,25,19,68,26,1,1559,MF,18.7,2,0,0,37,1,14,19,31,0,0,97,31,30,50.8
1561,DF,18.4,24,17,14,10,0,12,22,54.5,10,33,24,9,25,49,83,1,1561,DF,18.4,4,0,0,21,6,3,25,17,0,0,78,69,19,78.4
1564,MF,11.1,14,9,5,8,1,5,14,35.7,9,19,2,17,6,20,11,0,1564,MF,11.1,0,0,0,4,0,85,6,9,1,0,58,6,4,60.0
1568,DF,34.0,85,49,58,24,3,38,74,51.4,36,66,32,34,49,134,158,1,1568,DF,34.0,1,0,0,24,2,0,49,49,1,0,183,119,84,58.6
1569,MF,21.4,47,27,20,16,11,21,45,46.7,24,20,12,8,22,69,30,1,1569,MF,21.4,3,0,0,15,0,6,22,27,0,0,96,19,26,42.2
1570,"DF,MF",15.9,34,18,12,14,8,19,37,51.4,18,16,6,10,17,51,29,1,1570,"DF,MF",15.9,1,1,0,5,1,21,17,18,0,0,93,18,21,46.2
1572,MF,0.2,0,0,0,0,0,0,0,,0,0,0,0,0,0,1,0,1572,MF,0.2,0,0,0,0,0,1,0,0,0,0,2,0,0,
1575,DF,11.4,17,11,11,5,1,6,10,60.0,4,16,4,12,11,28,37,0,1575,DF,11.4,1,0,0,14,1,23,11,11,2,0,46,17,15,53.1
1576,MF,30.0,41,24,21,15,5,15,30,50.0,15,23,4,19,16,57,27,2,1576,MF,30.0,5,2,1,28,1,11,16,24,0,0,159,11,20,35.5
1577,MF,36.3,65,43,26,31,8,23,41,56.1,18,56,23,33,46,111,61,0,1577,MF,36.3,4,0,0,20,1,5,46,43,1,0,140,70,61,53.4
1578,DF,6.7,18,13,12,3,3,16,24,66.7,8,8,1,7,13,31,26,0,1578,DF,6.7,1,0,0,10,0,6,13,13,1,0,31,9,10,47.4
1581,MF,28.9,74,48,30,36,8,23,52,44.2,29,62,7,55,25,99,29,0,1581,MF,28.9,11,0,0,56,0,47,25,48,2,0,172,17,34,33.3
1583,MF,17.2,35,20,18,11,6,17,41,41.5,24,22,8,14,5,40,16,0,1583,MF,17.2,7,0,0,31,0,19,5,20,0,0,88,22,19,53.7
1584,MF,25.4,43,26,14,24,5,25,59,42.4,34,33,9,24,25,68,88,0,1584,MF,25.4,1,0,0,44,0,4,25,26,2,1,132,67,49,57.8
1588,"DF,MF",2.7,6,4,3,2,1,4,7,57.1,3,1,0,1,1,7,4,1,1588,"DF,MF",2.7,1,0,0,3,0,8,1,4,0,0,20,2,2,50.0
1590,DF,31.9,34,20,21,11,2,11,27,40.7,16,38,26,12,36,70,77,1,1590,DF,31.9,9,0,0,49,0,24,36,20,0,0,106,42,33,56.0
1594,DF,8.1,30,22,16,11,3,19,22,86.4,3,10,2,8,15,45,21,0,1594,DF,8.1,2,0,0,14,0,6,15,22,0,0,53,12,10,54.5
1595,DF,12.4,13,8,8,5,0,7,14,50.0,7,10,7,3,8,21,41,0,1595,DF,12.4,3,0,0,7,0,0,8,8,1,0,49,12,11,52.2
1596,MF,17.6,26,11,8,13,5,10,22,45.5,12,14,3,11,9,35,18,1,1596,MF,17.6,5,0,0,26,0,34,9,11,0,0,60,31,39,44.3
1597,MF,17.4,27,13,16,10,1,14,29,48.3,15,12,6,6,26,53,32,0,1597,MF,17.4,6,0,0,23,0,2,26,13,0,0,74,9,3,75.0
1598,MF,4.4,5,3,0,2,3,1,3,33.3,2,3,2,1,5,10,6,0,1598,MF,4.4,0,0,0,11,0,2,5,3,1,0,9,5,8,38.5
1600,DF,5.4,9,5,6,3,0,6,8,75.0,2,10,7,3,2,11,20,0,1600,DF,5.4,0,0,0,5,0,1,2,5,0,0,19,20,8,71.4
1601,"DF,MF",8.3,15,11,6,5,4,8,15,53.3,7,14,3,11,3,18,17,0,1601,"DF,MF",8.3,3,0,0,14,0,5,3,11,0,0,30,13,10,56.5
1602,MF,1.9,2,0,0,1,1,0,0,,0,1,0,1,0,2,0,0,1602,MF,1.9,1,0,0,4,0,4,0,0,0,0,7,0,3,0.0
1604,"DF,MF",2.5,8,5,6,1,1,4,5,80.0,1,6,0,6,1,9,3,0,1604,"DF,MF",2.5,0,0,0,3,0,20,1,5,0,0,11,3,1,75.0
1605,"MF,DF",0.8,1,1,1,0,0,1,1,100.0,0,1,0,1,0,1,3,0,1605,"MF,DF",0.8,0,0,0,2,0,3,0,1,0,0,1,2,1,66.7
1606,DF,3.9,9,6,5,4,0,6,10,60.0,4,8,6,2,4,13,11,1,1606,DF,3.9,2,0,0,5,0,0,4,6,0,0,18,5,3,62.5
1608,DF,12.8,7,6,4,3,0,3,13,23.1,10,10,2,8,7,14,33,0,1608,DF,12.8,1,0,0,6,0,22,7,6,0,0,43,9,12,42.9
1609,DF,25.2,22,10,11,11,0,12,18,66.7,6,28,17,11,25,47,76,0,1609,DF,25.2,4,0,0,26,0,14,25,10,3,0,95,39,38,50.6
1610,DF,25.1,56,39,26,24,6,42,71,59.2,29,28,6,22,15,71,44,0,1610,DF,25.1,5,0,0,22,5,121,15,39,0,0,124,13,16,44.8
1613,DF,29.1,41,25,34,7,0,22,34,64.7,12,40,25,15,37,78,115,1,1613,DF,29.1,7,0,0,37,0,4,37,25,1,0,98,41,20,67.2
1614,DF,14.7,18,10,10,7,1,5,16,31.3,11,16,12,4,10,28,95,0,1614,DF,14.7,5,0,0,17,0,1,10,10,0,0,49,31,18,63.3
1617,DF,27.1,32,20,23,9,0,14,27,51.9,13,34,21,13,33,65,129,2,1617,DF,27.1,6,0,0,28,0,1,33,20,0,1,117,56,43,56.6
1618,MF,20.2,40,22,13,23,4,19,29,65.5,10,16,4,12,6,46,30,2,1618,MF,20.2,3,0,0,28,1,98,6,22,0,0,91,12,12,50.0
1620,DF,19.6,22,8,15,6,1,10,27,37.0,17,26,13,13,30,52,106,4,1620,DF,19.6,0,1,0,21,1,0,30,8,0,0,81,47,38,55.3
1621,DF,35.3,70,42,44,24,2,35,53,66.0,18,39,19,20,44,114,147,2,1621,DF,35.3,6,1,1,23,3,5,44,42,3,1,187,31,34,47.7
1624,DF,17.1,19,11,10,7,2,11,17,64.7,6,29,19,10,17,36,58,1,1624,DF,17.1,1,0,0,3,2,0,17,11,0,0,96,24,22,52.2
1626,MF,8.1,13,7,7,3,3,6,18,33.3,12,4,1,3,4,17,7,1,1626,MF,8.1,1,0,0,10,0,1,4,7,0,0,51,6,5,54.5
1627,MF,27.3,70,43,32,34,4,37,67,55.2,30,65,19,46,43,113,80,0,1627,MF,27.3,6,0,0,52,2,19,43,43,1,0,152,70,54,56.5
1630,DF,15.3,21,10,7,10,4,9,22,40.9,13,12,4,8,9,30,15,0,1630,DF,15.3,4,1,1,23,2,106,9,10,0,0,48,8,11,42.1
1631,MF,30.3,44,25,22,15,7,22,57,38.6,35,25,3,22,21,65,14,0,1631,MF,30.3,5,0,0,27,4,10,21,25,1,0,146,8,24,25.0
1632,DF,0.3,0,0,0,0,0,0,0,,0,0,0,0,0,0,3,0,1632,DF,0.3,0,0,0,0,0,0,0,0,0,0,0,1,0,100.0
1633,MF,13.4,43,27,17,24,2,21,36,58.3,15,16,2,14,9,52,28,2,1633,MF,13.4,5,0,0,27,1,7,9,27,0,0,109,25,15,62.5
1634,MF,0.2,5,1,0,2,3,3,4,75.0,1,2,1,1,0,5,0,0,1634,MF,0.2,0,0,0,1,0,0,0,1,0,0,2,0,0,
1637,DF,13.8,25,16,17,6,2,15,32,46.9,17,15,5,10,10,35,41,3,1637,DF,13.8,5,0,0,14,1,7,10,16,0,0,65,10,13,43.5
1639,DF,14.4,10,7,9,1,0,6,8,75.0,2,13,10,3,11,21,50,0,1639,DF,14.4,5,0,0,10,1,3,11,7,0,0,69,33,27,55.0
1642,DF,7.2,12,8,8,4,0,5,12,41.7,7,10,8,2,5,17,26,0,1642,DF,7.2,3,0,0,6,0,2,5,8,0,1,33,4,5,44.4
1644,DF,25.5,75,47,43,28,4,36,54,66.7,18,38,14,24,30,105,69,4,1644,DF,25.5,9,0,0,41,1,5,30,47,0,0,141,49,55,47.1
1645,DF,34.4,45,31,24,19,2,27,49,55.1,22,27,7,20,29,74,63,2,1645,DF,34.4,3,1,0,24,4,44,29,31,1,0,154,32,33,49.2
1647,MF,17.5,33,16,16,17,0,18,35,51.4,17,24,8,16,31,64,30,1,1647,MF,17.5,8,1,1,31,0,4,31,16,0,1,103,30,24,55.6
1648,DF,0.7,4,0,2,2,0,2,4,50.0,2,2,1,1,2,6,5,0,1648,DF,0.7,2,0,0,3,0,0,2,0,0,0,5,4,1,80.0
1649,DF,11.4,17,12,8,8,1,5,20,25.0,15,12,6,6,11,28,30,0,1649,DF,11.4,0,0,0,18,0,4,11,12,1,0,49,22,14,61.1
1650,"DF,MF",24.7,64,40,37,22,5,37,70,52.9,33,32,10,22,25,89,75,2,1650,"DF,MF",24.7,7,0,0,22,0,5,25,40,0,1,117,35,53,39.8
1651,"MF,DF",0.2,1,1,1,0,0,0,0,,0,1,0,1,0,1,0,0,1651,"MF,DF",0.2,0,0,0,0,0,2,0,1,0,0,1,0,1,0.0
1653,DF,24.7,43,24,29,8,6,23,40,57.5,17,35,16,19,40,83,61,0,1653,DF,24.7,6,0,0,29,1,52,40,24,0,0,145,27,27,50.0
1655,MF,23.0,34,24,11,17,6,15,36,41.7,21,21,5,16,31,65,28,1,1655,MF,23.0,9,0,0,32,0,25,31,24,0,0,144,24,27,47.1
1656,MF,1.1,3,1,0,3,0,2,4,50.0,2,1,1,0,3,6,0,0,1656,MF,1.1,2,0,0,5,0,1,3,1,0,0,12,4,1,80.0
1658,MF,11.4,19,10,7,9,3,9,12,75.0,3,15,7,8,27,46,19,0,1658,MF,11.4,7,0,0,14,1,5,27,10,0,0,106,19,12,61.3
1659,MF,13.9,17,11,8,7,2,9,19,47.4,10,17,6,11,16,33,17,1,1659,MF,13.9,2,0,0,8,0,4,16,11,0,1,103,20,10,66.7
1660,DF,8.7,12,6,7,4,1,8,12,66.7,4,16,12,4,9,21,43,0,1660,DF,8.7,2,0,0,7,1,0,9,6,0,1,58,28,10,73.7
1661,MF,0.0,0,0,0,0,0,0,0,,0,0,0,0,0,0,0,0,1661,MF,0.0,0,0,0,0,0,0,0,0,0,0,0,0,0,
1662,DF,13.1,18,11,11,7,0,10,18,55.6,8,14,10,4,13,31,74,1,1662,DF,13.1,2,0,0,12,1,0,13,11,3,0,67,23,13,63.9
1663,DF,3.3,9,7,5,3,1,2,7,28.6,5,4,1,3,4,13,4,0,1663,DF,3.3,2,0,0,10,0,0,4,7,1,0,23,10,8,55.6
1666,DF,1.2,1,1,1,0,0,1,1,100.0,0,6,3,3,2,3,4,0,1666,DF,1.2,0,0,0,0,0,0,2,1,0,1,6,3,2,60.0
1667,MF,15.4,39,27,17,19,3,22,32,68.8,10,21,3,18,33,72,32,1,1667,MF,15.4,3,0,0,16,0,0,33,27,0,0,117,25,15,62.5
1668,MF,8.8,7,3,3,4,0,4,7,57.1,3,9,2,7,11,18,17,0,1668,MF,8.8,2,0,0,8,0,1,11,3,0,0,38,13,8,61.9
1672,DF,16.7,28,16,17,9,2,17,21,81.0,4,21,13,8,23,51,79,3,1672,DF,16.7,2,0,0,15,0,1,23,16,0,2,70,44,23,65.7
1673,DF,12.4,22,15,14,4,4,9,23,39.1,14,22,11,11,22,44,41,1,1673,DF,12.4,3,0,0,13,0,4,22,15,0,0,76,19,27,41.3
1674,DF,15.0,26,17,6,18,2,19,26,73.1,7,18,1,17,7,33,18,2,1674,DF,15.0,2,0,0,7,2,59,7,17,1,0,65,12,16,42.9
1677,MF,0.0,0,0,0,0,0,0,0,,0,0,0,0,0,0,0,0,1677,MF,0.0,0,0,0,1,0,0,0,0,0,0,0,0,0,
1681,DF,13.3,32,21,14,11,7,13,21,61.9,8,14,1,13,20,52,27,1,1681,DF,13.3,3,0,0,10,0,19,20,21,0,0,63,19,21,47.5
1682,MF,24.6,45,23,15,24,6,26,49,53.1,23,23,7,16,19,64,62,0,1682,MF,24.6,6,1,1,45,1,42,19,23,0,0,128,41,38,51.9
1683,DF,14.1,25,19,14,10,1,16,29,55.2,13,14,6,8,5,30,31,0,1683,DF,14.1,4,0,0,23,3,42,5,19,0,0,72,6,26,18.8
1684,DF,4.8,5,2,1,2,2,2,3,66.7,1,5,1,4,1,6,13,0,1684,DF,4.8,0,1,0,9,0,14,1,2,0,0,21,12,7,63.2
1685,DF,22.7,51,39,25,18,8,23,40,57.5,17,29,9,20,24,75,48,0,1685,DF,22.7,5,0,0,45,2,101,24,39,0,0,119,26,15,63.4
1686,MF,0.2,0,0,0,0,0,0,0,,0,0,0,0,1,1,0,0,1686,MF,0.2,0,0,0,1,0,1,1,0,0,0,1,0,0,
1687,"MF,DF",0.5,0,0,0,0,0,0,2,0.0,2,1,0,1,0,0,0,0,1687,"MF,DF",0.5,0,0,0,1,0,1,0,0,0,0,1,0,0,
1690,DF,3.2,6,3,3,3,0,2,5,40.0,3,10,7,3,5,11,26,0,1690,DF,3.2,2,0,0,6,0,0,5,3,1,0,10,9,5,64.3
1691,DF,24.5,33,21,25,7,1,17,30,56.7,13,21,13,8,13,46,95,1,1691,DF,24.5,1,0,0,21,2,15,13,21,0,1,102,40,32,55.6
1692,MF,0.2,2,1,0,1,1,1,2,50.0,1,0,0,0,0,2,0,0,1692,MF,0.2,0,0,0,0,0,2,0,1,0,0,1,0,0,
1698,MF,0.0,0,0,0,0,0,0,0,,0,1,0,1,0,0,0,0,1698,MF,0.0,0,0,0,0,0,0,0,0,0,0,0,0,0,
1700,MF,0.0,0,0,0,0,0,0,0,,0,1,0,1,1,1,0,0,1700,MF,0.0,0,0,0,1,0,0,1,0,0,0,0,0,0,
1702,DF,4.6,4,0,3,1,0,2,3,66.7,1,6,4,2,5,9,27,0,1702,DF,4.6,0,0,0,3,0,0,5,0,0,0,25,20,3,87.0
1703,"MF,DF",28.8,48,29,31,11,6,17,27,63.0,10,28,7,21,18,66,69,0,1703,"MF,DF",28.8,6,0,0,23,6,59,18,29,0,0,115,37,34,52.1
1706,DF,30.2,64,38,25,31,8,44,69,63.8,25,38,13,25,24,88,59,2,1706,DF,30.2,11,0,0,51,2,20,24,38,0,0,229,37,22,62.7
1707,DF,14.1,26,15,12,12,2,17,22,77.3,5,21,13,8,13,39,63,1,1707,DF,14.1,1,1,0,7,1,5,13,15,0,0,67,35,32,52.2
1708,MF,16.5,28,21,10,14,4,11,27,40.7,16,21,2,19,33,61,15,0,1708,MF,16.5,3,0,0,20,8,18,33,21,0,0,82,13,13,50.0
1709,DF,7.1,16,10,13,3,0,8,12,66.7,4,11,5,6,11,27,35,0,1709,DF,7.1,1,0,0,10,0,4,11,10,1,0,37,22,9,71.0
1710,DF,1.6,2,1,2,0,0,0,1,0.0,1,3,2,1,3,5,9,0,1710,DF,1.6,0,0,0,0,0,0,3,1,0,0,6,1,2,33.3
1712,MF,1.2,3,3,1,2,0,0,1,0.0,1,1,0,1,0,3,0,0,1712,MF,1.2,2,0,0,4,0,2,0,3,0,0,6,0,1,0.0
1715,DF,0.2,1,1,1,0,0,1,1,100.0,0,1,0,1,0,1,0,0,1715,DF,0.2,0,0,0,0,0,0,0,1,0,0,0,0,1,0.0
1716,MF,22.1,45,30,17,24,4,26,42,61.9,16,27,3,24,18,63,8,0,1716,MF,22.1,2,0,0,18,0,21,18,30,0,0,141,7,7,50.0
1718,DF,4.4,16,13,11,5,0,8,16,50.0,8,4,2,2,1,17,17,1,1718,DF,4.4,0,0,0,6,1,4,1,13,0,0,23,7,5,58.3
1719,DF,3.0,5,5,4,1,0,4,7,57.1,3,4,0,4,4,9,2,0,1719,DF,3.0,3,0,0,6,0,7,4,5,0,0,14,6,2,75.0
1720,MF,0.1,0,0,0,0,0,0,0,,0,0,0,0,0,0,0,0,1720,MF,0.1,0,0,0,0,0,0,0,0,0,0,2,0,0,
1722,DF,14.8,36,17,19,12,5,21,37,56.8,16,24,6,18,26,62,45,0,1722,DF,14.8,4,0,0,14,0,8,26,17,0,0,65,20,17,54.1
1723,MF,0.1,1,1,1,0,0,1,1,100.0,0,0,0,0,1,2,0,0,1723,MF,0.1,0,0,0,1,0,0,1,1,0,0,1,1,0,100.0
1724,MF,0.0,0,0,0,0,0,0,0,,0,0,0,0,0,0,0,0,1724,MF,0.0,0,0,0,0,0,0,0,0,0,0,0,0,0,
1725,DF,4.6,7,5,4,3,0,3,7,42.9,4,4,1,3,8,15,16,0,1725,DF,4.6,0,0,0,4,0,4,8,5,1,0,22,7,12,36.8
1726,DF,7.9,3,1,2,1,0,1,5,20.0,4,8,2,6,7,10,20,0,1726,DF,7.9,3,0,0,12,4,96,7,1,0,0,31,4,7,36.4
1727,DF,19.1,15,10,12,2,1,11,14,78.6,3,12,2,10,13,28,26,1,1727,DF,19.1,5,0,0,17,0,5,13,10,0,0,97,6,5,54.5
1728,DF,14.0,33,19,24,8,1,20,33,60.6,13,23,12,11,20,53,59,1,1728,DF,14.0,6,0,0,16,0,13,20,19,2,1,90,43,15,74.1
1729,MF,11.7,29,18,10,13,6,16,20,80.0,4,11,4,7,14,43,14,1,1729,MF,11.7,2,0,0,16,0,7,14,18,0,0,91,10,5,66.7
1730,DF,27.4,54,22,33,20,1,19,30,63.3,11,39,27,12,57,111,140,1,1730,DF,27.4,3,0,0,35,1,2,57,22,1,0,126,60,43,58.3
1731,DF,6.9,12,11,9,3,0,9,14,64.3,5,13,6,7,7,19,30,1,1731,DF,6.9,2,0,0,15,0,1,7,11,0,0,31,29,20,59.2
1732,DF,7.5,8,7,6,2,0,4,7,57.1,3,5,3,2,8,16,33,0,1732,DF,7.5,0,0,0,1,0,1,8,7,0,0,38,8,11,42.1
1734,MF,27.6,77,43,25,34,18,22,48,45.8,26,36,11,25,16,93,55,3,1734,MF,27.6,10,0,0,70,6,19,16,43,1,0,197,164,107,60.5
1735,DF,7.8,13,12,7,5,1,8,20,40.0,12,4,0,4,6,19,14,0,1735,DF,7.8,1,0,0,10,0,40,6,12,0,0,38,2,10,16.7
1736,DF,14.3,29,20,15,12,2,16,25,64.0,9,22,1,21,18,47,22,0,1736,DF,14.3,0,0,0,10,3,63,18,20,0,0,88,7,10,41.2
1737,"MF,DF",11.7,26,20,19,5,2,8,19,42.1,11,9,1,8,5,31,22,0,1737,"MF,DF",11.7,0,0,0,7,5,24,5,20,0,0,54,15,24,38.5
1738,DF,6.5,5,1,3,2,0,3,13,23.1,10,8,2,6,4,9,22,0,1738,DF,6.5,0,0,0,10,0,17,4,1,0,0,43,7,6,53.8
1739,DF,0.1,0,0,0,0,0,0,0,,0,0,0,0,0,0,1,0,1739,DF,0.1,0,1,0,1,0,0,0,0,0,0,1,0,0,
1746,DF,27.9,41,21,24,14,3,22,36,61.1,14,22,14,8,27,68,95,1,1746,DF,27.9,4,0,0,30,0,0,27,21,1,0,108,111,28,79.9
1747,MF,13.4,33,21,6,20,7,15,32,46.9,17,20,3,17,8,41,18,2,1747,MF,13.4,1,0,0,5,2,11,8,21,0,0,78,11,12,47.8
1750,DF,5.5,7,3,4,3,0,6,9,66.7,3,4,3,1,4,11,19,1,1750,DF,5.5,0,0,0,5,2,1,4,3,0,0,19,11,13,45.8
1751,MF,23.5,57,33,19,28,10,28,47,59.6,19,20,1,19,32,89,10,0,1751,MF,23.5,6,0,0,43,1,102,32,33,0,0,174,28,25,52.8
1753,"DF,MF",8.6,20,14,9,10,1,9,14,64.3,5,9,0,9,8,28,16,0,1753,"DF,MF",8.6,3,0,0,10,3,29,8,14,1,0,45,6,13,31.6
1756,DF,21.9,37,24,21,11,5,12,24,50.0,12,29,19,10,45,82,70,2,1756,DF,21.9,3,0,0,19,1,2,45,24,0,0,143,75,29,72.1
1757,"DF,MF",0.5,1,1,1,0,0,1,2,50.0,1,0,0,0,0,1,2,0,1757,"DF,MF",0.5,1,0,0,3,0,0,0,1,0,0,6,1,0,100.0
1758,DF,13.5,20,13,14,6,0,13,19,68.4,6,23,14,9,4,24,77,0,1758,DF,13.5,4,0,0,17,0,2,4,13,1,0,57,35,14,71.4
1759,MF,23.5,34,17,10,13,11,16,54,29.6,38,29,1,28,11,45,8,0,1759,MF,23.5,4,0,0,30,5,32,11,17,0,0,115,6,13,31.6
1760,"DF,MF",10.9,29,16,19,6,4,17,34,50.0,17,17,4,13,8,37,27,0,1760,"DF,MF",10.9,1,1,0,4,0,26,8,16,1,0,50,10,13,43.5
1761,DF,0.3,0,0,0,0,0,0,0,,0,0,0,0,1,1,1,0,1761,DF,0.3,0,0,0,0,0,0,1,0,0,0,2,1,0,100.0
1762,"DF,MF",33.3,62,38,44,11,7,37,80,46.3,43,38,7,31,17,79,49,2,1762,"DF,MF",33.3,4,0,0,21,1,148,17,38,1,0,164,16,18,47.1
1763,DF,33.2,47,30,39,6,2,23,40,57.5,17,32,16,16,45,92,132,4,1763,DF,33.2,5,0,0,32,0,3,45,30,0,0,136,56,55,50.5
1765,MF,0.4,1,0,0,1,0,0,1,0.0,1,1,0,1,0,1,0,0,1765,MF,0.4,0,0,0,0,0,0,0,0,0,0,4,0,0,
1767,DF,20.6,38,24,21,13,4,17,31,54.8,14,31,6,25,19,57,62,0,1767,DF,20.6,8,0,0,21,3,62,19,24,1,0,83,26,27,49.1
1768,DF,0.2,0,0,0,0,0,0,0,,0,0,0,0,0,0,1,0,1768,DF,0.2,0,0,0,0,0,0,0,0,0,0,1,0,0,
1770,MF,12.3,18,14,6,8,4,10,26,38.5,16,10,1,9,7,25,6,0,1770,MF,12.3,3,0,0,22,1,32,7,14,0,0,73,3,12,20.0
1771,DF,3.0,6,3,2,4,0,4,11,36.4,7,3,2,1,4,10,8,0,1771,DF,3.0,0,0,0,1,0,5,4,3,0,0,8,6,1,85.7
1772,"DF,MF",35.6,105,60,75,21,9,43,60,71.7,17,63,10,53,26,131,104,0,1772,"DF,MF",35.6,6,0,0,22,1,69,26,60,0,0,208,21,26,44.7
1776,DF,7.8,9,3,7,2,0,4,8,50.0,4,3,2,1,6,15,26,0,1776,DF,7.8,3,0,0,13,0,0,6,3,1,0,27,11,20,35.5
1777,DF,23.4,91,51,46,39,6,53,89,59.6,36,36,6,30,46,137,65,0,1777,DF,23.4,5,0,0,28,1,105,46,51,0,0,140,30,20,60.0
1778,MF,30.9,62,34,18,35,9,24,49,49.0,25,23,4,19,29,91,43,0,1778,MF,30.9,4,0,0,35,3,32,29,34,0,0,182,15,16,48.4
1779,MF,0.1,0,0,0,0,0,0,0,,0,0,0,0,0,0,0,0,1779,MF,0.1,0,0,0,0,0,0,0,0,0,0,2,0,0,
1780,"MF,DF",6.9,19,10,9,5,5,9,18,50.0,9,8,2,6,2,21,12,0,1780,"MF,DF",6.9,2,0,0,8,2,6,2,10,0,0,40,3,5,37.5
1781,MF,18.8,22,15,10,6,6,9,25,36.0,16,13,4,9,21,43,9,0,1781,MF,18.8,2,0,0,19,2,90,21,15,0,0,92,8,8,50.0
1786,DF,22.7,30,22,11,15,4,16,25,64.0,9,15,2,13,21,51,40,2,1786,DF,22.7,1,0,0,22,0,116,21,22,0,0,168,15,14,51.7
1788,DF,20.6,38,22,16,18,4,26,54,48.1,28,19,3,16,9,47,36,1,1788,DF,20.6,4,1,0,20,7,87,9,22,0,0,122,7,11,38.9
1790,MF,20.0,27,18,14,10,3,17,42,40.5,25,31,5,26,15,42,21,0,1790,MF,20.0,2,1,0,24,0,90,15,18,0,0,98,16,14,53.3
1791,DF,0.1,1,1,1,0,0,1,2,50.0,1,1,1,0,1,2,0,0,1791,DF,0.1,0,0,0,0,0,0,1,1,0,0,0,0,1,0.0
1792,DF,16.3,23,13,14,7,2,12,26,46.2,14,22,18,4,8,31,63,0,1792,DF,16.3,1,0,0,10,1,5,8,13,1,0,77,41,28,59.4
1793,DF,19.9,22,13,13,9,0,9,18,50.0,9,21,9,12,11,33,94,0,1793,DF,19.9,5,0,0,22,2,3,11,13,0,0,64,59,24,71.1
1794,DF,8.9,22,19,12,8,2,16,29,55.2,13,8,3,5,9,31,31,1,1794,DF,8.9,5,0,0,6,2,16,9,19,1,0,42,12,8,60.0
1797,MF,0.0,0,0,0,0,0,0,0,,0,0,0,0,0,0,1,0,1797,MF,0.0,0,0,0,1,0,0,0,0,0,0,0,0,0,
1800,DF,16.5,31,21,19,10,2,10,30,33.3,20,12,2,10,24,55,33,0,1800,DF,16.5,5,2,2,24,5,49,24,21,0,0,76,10,13,43.5
1801,DF,11.5,18,12,18,0,0,12,19,63.2,7,11,2,9,13,31,37,0,1801,DF,11.5,2,0,0,11,2,37,13,12,0,1,40,4,10,28.6
1803,DF,0.2,0,0,0,0,0,0,0,,0,1,0,1,0,0,3,0,1803,DF,0.2,0,0,0,0,0,1,0,0,0,0,1,1,1,50.0
1804,DF,1.2,2,2,1,1,0,2,4,50.0,2,3,1,2,1,3,3,0,1804,DF,1.2,0,0,0,3,1,1,1,2,0,0,7,2,2,50.0
1806,MF,17.9,50,29,23,26,1,23,53,43.4,30,13,1,12,20,70,21,0,1806,MF,17.9,2,0,0,15,0,17,20,29,0,0,125,17,13,56.7
1807,MF,9.3,21,16,8,12,1,8,15,53.3,7,14,1,13,7,28,10,0,1807,MF,9.3,0,0,0,11,0,13,7,16,0,0,46,4,13,23.5
1809,DF,34.2,57,34,36,18,3,25,39,64.1,14,42,23,19,36,93,137,2,1809,DF,34.2,2,0,0,25,0,1,36,34,1,0,147,52,66,44.1
1810,DF,13.7,27,13,18,7,2,12,15,80.0,3,12,2,10,17,44,65,0,1810,DF,13.7,4,0,0,14,0,7,17,13,0,0,72,26,8,76.5
1816,MF,12.3,38,20,14,17,7,17,37,45.9,20,16,3,13,11,49,13,0,1816,MF,12.3,2,0,0,21,1,2,11,20,1,0,74,8,16,33.3
1817,DF,1.0,4,1,4,0,0,1,1,100.0,0,1,0,1,0,4,3,0,1817,DF,1.0,0,0,0,1,1,0,0,1,0,0,3,0,1,0.0
1820,"MF,DF",2.0,0,0,0,0,0,0,3,0.0,3,2,0,2,1,1,1,0,1820,"MF,DF",2.0,1,0,0,3,0,7,1,0,0,0,7,2,1,66.7
1821,DF,8.8,12,8,6,5,1,8,15,53.3,7,17,4,13,14,26,28,0,1821,DF,8.8,2,0,0,14,1,3,14,8,0,0,53,26,8,76.5
1823,MF,3.9,14,9,8,5,1,4,9,44.4,5,5,2,3,4,18,5,0,1823,MF,3.9,3,0,0,5,0,2,4,9,0,0,20,3,1,75.0
1824,"DF,MF",12.6,33,16,21,9,3,16,27,59.3,11,24,12,12,17,50,39,1,1824,"DF,MF",12.6,5,0,0,19,0,7,17,16,0,0,66,21,17,55.3
1826,MF,0.2,0,0,0,0,0,0,0,,0,0,0,0,0,0,0,0,1826,MF,0.2,0,0,0,1,0,0,0,0,0,0,0,3,1,75.0
1828,DF,18.8,19,10,13,4,2,8,10,80.0,2,27,19,8,22,41,82,1,1828,DF,18.8,5,1,0,15,0,2,22,10,0,0,79,39,31,55.7
1829,MF,24.1,61,39,18,34,9,33,61,54.1,28,21,7,14,14,75,33,0,1829,MF,24.1,5,0,0,45,3,18,14,39,0,0,110,42,33,56.0
1832,DF,12.5,36,21,20,10,6,24,35,68.6,11,16,8,8,9,45,33,0,1832,DF,12.5,2,0,0,17,0,29,9,21,0,0,66,23,17,57.5
1833,"DF,MF",16.0,55,35,31,14,10,19,38,50.0,19,29,7,22,24,79,47,0,1833,"DF,MF",16.0,4,0,0,30,8,11,24,35,0,0,76,26,28,48.1
1834,MF,20.6,32,18,13,17,2,15,31,48.4,16,16,5,11,11,43,50,0,1834,MF,20.6,5,0,0,37,0,13,11,18,0,0,100,56,37,60.2
1835,MF,29.3,42,23,14,22,6,16,44,36.4,28,40,4,36,20,62,29,1,1835,MF,29.3,6,0,0,36,2,47,20,23,1,0,114,6,19,24.0
1836,MF,0.0,0,0,0,0,0,0,0,,0,0,0,0,0,0,0,0,1836,MF,0.0,0,0,0,0,0,0,0,0,0,0,0,0,0,
1839,DF,31.0,50,31,36,13,1,19,33,57.6,14,41,24,17,37,87,188,0,1839,DF,31.0,5,0,0,38,0,4,37,31,0,1,146,38,40,48.7
1851,DF,22.2,34,15,15,16,3,16,33,48.5,17,27,3,24,17,51,47,0,1851,DF,22.2,4,1,0,34,3,86,17,15,0,0,88,18,18,50.0
1852,DF,27.4,69,38,46,21,2,41,66,62.1,25,36,11,25,36,105,92,0,1852,DF,27.4,1,0,0,23,1,56,36,38,0,0,142,30,27,52.6
1853,"DF,MF",27.2,62,39,33,18,11,41,64,64.1,23,43,5,38,29,91,65,0,1853,"DF,MF",27.2,5,0,0,19,2,60,29,39,1,0,134,22,24,47.8
1854,DF,24.1,32,18,12,19,1,12,20,60.0,8,30,16,14,16,48,75,0,1854,DF,24.1,6,0,0,26,0,11,16,18,0,0,100,38,27,58.5
1855,MF,17.8,31,22,20,9,2,17,38,44.7,21,17,8,9,27,58,38,0,1855,MF,17.8,4,0,0,29,0,2,27,22,0,0,59,24,14,63.2
1857,DF,7.0,21,10,12,8,1,17,29,58.6,12,13,2,11,8,29,33,0,1857,DF,7.0,3,1,1,12,0,7,8,10,1,0,46,12,9,57.1
1858,DF,19.4,18,10,9,7,2,6,13,46.2,7,23,13,10,18,36,56,0,1858,DF,19.4,4,2,0,21,2,3,18,10,0,0,82,27,18,60.0
1860,DF,1.2,1,1,0,0,1,0,2,0.0,2,2,1,1,4,5,0,0,1860,DF,1.2,0,0,0,0,0,12,4,1,0,0,8,2,5,28.6
1861,MF,12.6,40,24,24,14,2,24,42,57.1,18,23,6,17,11,51,11,1,1861,MF,12.6,5,0,0,24,0,4,11,24,0,0,90,4,7,36.4
1863,"MF,DF",26.0,59,40,27,23,9,27,64,42.2,37,25,2,23,19,78,32,0,1863,"MF,DF",26.0,7,0,0,52,9,154,19,40,0,0,135,37,46,44.6
1864,DF,25.1,35,17,26,9,0,24,32,75.0,8,33,20,13,29,64,114,0,1864,DF,25.1,8,0,0,33,2,5,29,17,0,0,91,44,27,62.0
1865,DF,10.6,14,10,10,3,1,5,10,50.0,5,12,9,3,8,22,32,0,1865,DF,10.6,3,1,1,13,0,5,8,10,0,0,39,25,23,52.1
1868,DF,22.3,37,27,21,14,2,22,40,55.0,18,15,7,8,22,59,48,0,1868,DF,22.3,6,1,0,12,1,143,22,27,1,0,99,10,14,41.7
1870,MF,1.2,4,3,0,3,1,1,1,100.0,0,0,0,0,0,4,2,1,1870,MF,1.2,0,0,0,2,1,1,0,3,0,0,13,3,1,75.0
1871,"MF,DF",19.0,31,20,17,12,2,12,23,52.2,11,19,11,8,12,43,47,1,1871,"MF,DF",19.0,6,1,0,15,0,1,12,20,0,0,95,35,22,61.4
1877,MF,0.3,2,2,0,2,0,1,2,50.0,1,0,0,0,0,2,0,0,1877,MF,0.3,1,0,0,1,0,0,0,2,0,0,5,0,3,0.0
1879,"MF,DF",8.3,11,4,6,3,2,1,9,11.1,8,11,3,8,11,22,15,1,1879,"MF,DF",8.3,2,0,0,13,0,0,11,4,0,0,35,6,14,30.0
1880,"DF,MF",17.3,37,26,21,12,4,18,30,60.0,12,12,2,10,16,53,17,0,1880,"DF,MF",17.3,3,0,0,22,3,44,16,26,0,0,95,8,7,53.3
1883,"MF,DF",0.1,1,0,1,0,0,0,0,,0,0,0,0,0,1,0,0,1883,"MF,DF",0.1,0,0,0,0,0,0,0,0,0,0,0,0,0,
1886,DF,24.7,38,22,19,16,3,23,43,53.5,20,36,10,26,22,60,76,1,1886,DF,24.7,2,0,0,26,1,74,22,22,2,0,130,37,29,56.1
1888,MF,13.6,15,12,7,8,0,8,26,30.8,18,8,6,2,14,29,8,0,1888,MF,13.6,4,0,0,9,0,10,14,12,0,0,70,7,7,50.0
1889,DF,35.0,32,21,22,9,1,17,40,42.5,23,39,14,25,30,62,108,2,1889,DF,35.0,4,0,0,22,0,83,30,21,0,0,135,27,31,46.6
1895,DF,16.2,42,25,33,9,0,20,25,80.0,5,19,12,7,14,56,51,0,1895,DF,16.2,5,1,1,11,0,11,14,25,0,0,98,15,5,75.0
1897,DF,3.5,12,8,9,2,1,8,11,72.7,3,2,0,2,3,15,9,1,1897,DF,3.5,3,0,0,6,0,0,3,8,0,0,18,4,5,44.4
1899,DF,32.5,50,30,39,11,0,26,44,59.1,18,44,33,11,42,92,158,1,1899,DF,32.5,6,1,1,45,0,0,42,30,2,0,150,108,36,75.0
1901,MF,3.0,5,2,1,3,1,4,6,66.7,2,5,1,4,0,5,2,0,1901,MF,3.0,1,0,0,1,0,18,0,2,0,0,18,2,2,50.0
1902,MF,15.3,64,39,29,29,6,30,49,61.2,19,36,9,27,14,78,56,0,1902,MF,15.3,10,1,1,41,2,16,14,39,0,0,72,47,32,59.5
1905,"DF,MF",14.5,54,30,34,17,3,29,64,45.3,35,30,2,28,16,70,30,0,1905,"DF,MF",14.5,5,1,1,27,0,53,16,30,1,0,102,17,27,38.6
1907,MF,11.3,19,13,7,8,4,11,22,50.0,11,18,5,13,11,30,19,0,1907,MF,11.3,3,0,0,9,1,3,11,13,0,0,47,20,8,71.4
1909,"DF,MF",0.1,1,1,1,0,0,1,1,100.0,0,0,0,0,0,1,1,0,1909,"DF,MF",0.1,0,0,0,0,0,0,0,1,0,0,1,2,0,100.0
1910,MF,0.3,0,0,0,0,0,0,0,,0,0,0,0,0,0,1,0,1910,MF,0.3,1,0,0,3,0,0,0,0,1,0,1,1,0,100.0
1911,MF,0.0,0,0,0,0,0,0,0,,0,0,0,0,0,0,0,0,1911,MF,0.0,0,0,0,0,0,0,0,0,0,0,0,0,0,
1913,DF,1.2,1,1,1,0,0,0,1,0.0,1,2,0,2,1,2,2,0,1913,DF,1.2,1,0,0,3,1,2,1,1,0,0,4,1,1,50.0
1914,MF,16.0,41,26,18,18,5,20,47,42.6,27,24,9,15,21,62,39,0,1914,MF,16.0,8,0,0,15,0,52,21,26,1,0,98,14,16,46.7
1919,DF,0.1,0,0,0,0,0,0,0,,0,0,0,0,0,0,0,0,1919,DF,0.1,0,0,0,1,0,0,0,0,0,0,0,0,0,
1920,MF,2.0,3,1,3,0,0,2,6,33.3,4,0,0,0,6,9,1,0,1920,MF,2.0,2,1,1,1,3,3,6,1,0,0,10,2,1,66.7
1921,MF,7.3,10,4,1,7,2,5,16,31.3,11,7,1,6,1,11,8,1,1921,MF,7.3,0,0,0,8,2,19,1,4,0,0,30,5,8,38.5
1923,DF,31.1,51,28,30,19,2,23,49,46.9,26,38,24,14,52,103,153,3,1923,DF,31.1,4,0,0,37,0,1,52,28,0,0,206,89,57,61.0
1924,"DF,MF",16.8,29,22,22,6,1,22,41,53.7,19,11,1,10,17,46,26,0,1924,"DF,MF",16.8,2,0,0,18,0,64,17,22,0,0,78,13,9,59.1
1927,DF,12.1,18,14,13,5,0,12,18,66.7,6,19,11,8,10,28,43,0,1927,DF,12.1,1,0,0,13,0,1,10,14,0,0,75,20,11,64.5
1931,MF,27.8,81,50,42,31,8,32,87,36.8,55,48,6,42,54,135,50,0,1931,MF,27.8,8,0,0,41,1,22,54,50,0,0,216,40,46,46.5
1932,DF,26.3,22,16,16,5,1,14,20,70.0,6,23,18,5,12,34,98,1,1932,DF,26.3,4,1,0,17,0,1,12,16,0,0,126,44,25,63.8
1934,DF,32.1,39,20,22,14,3,11,26,42.3,15,41,30,11,35,74,158,2,1934,DF,32.1,5,1,0,36,1,11,35,20,0,1,140,127,67,65.5
1936,DF,10.5,17,9,8,8,1,8,17,47.1,9,13,7,6,21,38,41,1,1936,DF,10.5,1,0,0,14,0,15,21,9,0,0,54,14,18,43.8
1937,MF,5.0,8,4,3,4,1,2,10,20.0,8,6,4,2,8,16,10,0,1937,MF,5.0,1,0,0,9,0,1,8,4,0,0,20,5,4,55.6
1944,DF,4.4,9,7,7,1,1,5,5,100.0,0,2,1,1,8,17,7,0,1944,DF,4.4,0,0,0,7,1,10,8,7,1,0,13,1,8,11.1
1945,DF,7.9,19,11,11,4,4,9,14,64.3,5,15,6,9,2,21,22,0,1945,DF,7.9,2,0,0,8,0,8,2,11,0,0,27,7,12,36.8
1946,DF,1.4,1,0,1,0,0,1,1,100.0,0,0,0,0,1,2,0,0,1946,DF,1.4,0,0,0,2,0,3,1,0,0,0,4,1,1,50.0
1947,"MF,DF",22.2,17,10,10,7,0,12,22,54.5,10,14,3,11,7,24,34,2,1947,"MF,DF",22.2,1,0,0,8,8,79,7,10,0,0,125,28,23,54.9
1948,DF,7.1,11,5,9,2,0,6,7,85.7,1,13,10,3,3,14,29,0,1948,DF,7.1,1,0,0,1,0,0,3,5,0,0,10,12,7,63.2
1949,DF,10.5,19,9,13,6,0,11,18,61.1,7,25,19,6,9,28,35,3,1949,DF,10.5,1,0,0,11,0,0,9,9,1,1,37,23,18,56.1
1952,DF,32.4,56,34,33,22,1,29,44,65.9,15,48,32,16,29,85,156,4,1952,DF,32.4,9,0,0,27,0,2,29,34,2,0,164,74,59,55.6
1955,DF,19.4,44,28,28,14,2,24,38,63.2,14,27,19,8,35,79,112,2,1955,DF,19.4,3,0,0,17,0,3,35,28,0,0,144,41,26,61.2
1958,MF,4.0,16,13,4,7,5,5,8,62.5,3,2,0,2,3,19,5,1,1958,MF,4.0,3,0,0,7,1,1,3,13,0,0,36,6,10,37.5
1959,MF,6.7,10,9,8,2,0,4,17,23.5,13,9,1,8,1,11,10,0,1959,MF,6.7,1,0,0,6,0,7,1,9,0,0,49,5,9,35.7
1962,DF,17.4,50,29,29,15,6,23,39,59.0,16,35,6,29,20,70,25,0,1962,DF,17.4,3,0,0,9,1,27,20,29,0,0,101,37,30,55.2
1963,MF,16.1,26,18,14,8,4,10,22,45.5,12,7,0,7,13,39,12,1,1963,MF,16.1,0,0,0,15,1,21,13,18,0,0,75,11,19,36.7
1965,DF,23.0,32,19,23,7,2,16,28,57.1,12,30,20,10,33,65,77,2,1965,DF,23.0,5,1,0,20,0,0,33,19,0,2,114,50,19,72.5
1966,"DF,MF",25.7,48,29,31,13,4,20,33,60.6,13,51,29,22,27,75,65,0,1966,"DF,MF",25.7,4,0,0,18,0,3,27,29,0,0,108,30,41,42.3
1968,DF,8.7,10,3,9,1,0,5,8,62.5,3,12,8,4,13,23,42,1,1968,DF,8.7,2,0,0,6,0,0,13,3,0,1,21,7,10,41.2
1971,MF,23.2,71,38,32,31,8,21,42,50.0,21,25,6,19,21,92,31,0,1971,MF,23.2,5,0,0,37,1,3,21,38,1,0,160,52,18,74.3
1973,MF,6.3,23,14,6,14,3,13,25,52.0,12,10,2,8,11,34,11,1,1973,MF,6.3,1,0,0,15,0,2,11,14,0,0,38,11,6,64.7
1976,MF,0.0,0,0,0,0,0,0,0,,0,0,0,0,0,0,0,0,1976,MF,0.0,0,0,0,0,0,0,0,0,0,0,0,0,0,
1977,"DF,MF",4.5,10,6,7,3,0,5,12,41.7,7,3,0,3,1,11,13,0,1977,"DF,MF",4.5,1,0,0,10,0,13,1,6,1,0,10,8,6,57.1
1978,MF,12.9,37,24,9,23,5,16,29,55.2,13,15,7,8,23,60,17,0,1978,MF,12.9,8,0,0,24,4,16,23,24,0,0,73,10,23,30.3
1981,DF,27.2,55,36,37,15,3,32,59,54.2,27,45,7,38,35,90,68,1,1981,DF,27.2,6,0,0,20,0,190,35,36,1,0,150,32,13,71.1
1984,DF,17.6,20,12,8,10,2,9,18,50.0,9,22,13,9,16,36,76,1,1984,DF,17.6,2,0,0,16,0,1,16,12,0,0,87,54,28,65.9
1985,DF,20.9,19,14,11,6,2,10,17,58.8,7,41,29,12,31,50,130,0,1985,DF,20.9,4,0,0,29,3,1,31,14,4,1,89,133,55,70.7
1988,MF,26.0,43,26,18,20,5,13,37,35.1,24,27,2,25,16,59,11,0,1988,MF,26.0,3,0,0,39,2,11,16,26,0,0,144,19,39,32.8
1991,DF,0.2,0,0,0,0,0,0,0,,0,0,0,0,0,0,0,0,1991,DF,0.2,0,0,0,0,0,1,0,0,0,0,0,0,0,
1992,MF,0.1,2,1,0,1,1,0,0,,0,0,0,0,0,2,0,0,1992,MF,0.1,0,0,0,1,0,0,0,1,0,0,1,2,2,50.0
1993,"DF,MF",15.2,22,9,11,9,2,8,17,47.1,9,18,2,16,8,30,30,0,1993,"DF,MF",15.2,3,0,0,8,1,47,8,9,0,1,80,6,22,21.4
1994,DF,20.5,41,22,21,19,1,16,27,59.3,11,37,20,17,31,72,92,0,1994,DF,20.5,3,0,0,23,1,3,31,22,0,0,103,36,36,50.0
1996,MF,0.1,0,0,0,0,0,0,0,,0,0,0,0,0,0,0,0,1996,MF,0.1,0,0,0,0,0,0,0,0,0,0,0,1,0,100.0
1997,MF,20.7,38,26,14,23,1,17,36,47.2,19,36,9,27,27,65,32,1,1997,MF,20.7,5,0,0,21,3,20,27,26,0,0,142,26,30,46.4
2003,MF,13.4,25,11,9,14,2,11,32,34.4,21,6,1,5,11,36,8,0,2003,MF,13.4,3,0,0,15,1,22,11,11,0,0,66,3,11,21.4
2006,DF,4.8,8,5,6,2,0,5,5,100.0,0,1,0,1,7,15,15,0,2006,DF,4.8,0,0,0,4,0,0,7,5,0,0,26,8,7,53.3
2009,DF,13.3,37,26,21,14,2,23,34,67.6,11,17,3,14,9,46,32,0,2009,DF,13.3,4,0,0,13,0,11,9,26,0,0,73,13,9,59.1
2010,MF,13.2,20,12,11,8,1,10,18,55.6,8,28,3,25,17,37,18,1,2010,MF,13.2,3,0,0,22,2,1,17,12,0,0,86,16,15,51.6
2011,DF,17.8,26,15,22,4,0,15,23,65.2,8,18,7,11,18,44,84,1,2011,DF,17.8,3,0,0,13,1,6,18,15,1,1,70,31,31,50.0
2012,"MF,DF",1.7,10,6,3,6,1,5,6,83.3,1,2,0,2,0,10,2,0,2012,"MF,DF",1.7,1,0,0,2,0,0,0,6,0,0,8,3,5,37.5
2013,DF,17.0,25,15,21,4,0,14,22,63.6,8,17,6,11,10,35,53,1,2013,DF,17.0,8,0,0,29,1,1,10,15,0,0,49,57,33,63.3
2014,DF,33.0,62,37,38,23,1,31,53,58.5,22,51,22,29,47,109,152,2,2014,DF,33.0,7,0,0,22,1,7,47,37,1,0,216,54,48,52.9
2016,MF,0.1,0,0,0,0,0,0,0,,0,0,0,0,0,0,0,0,2016,MF,0.1,0,0,0,1,0,1,0,0,0,0,0,1,0,100.0
2017,"MF,DF",0.6,2,2,1,1,0,0,6,0.0,6,3,2,1,0,2,2,0,2017,"MF,DF",0.6,0,0,0,3,0,1,0,2,0,0,3,0,1,0.0
2018,MF,1.8,10,6,5,4,1,6,10,60.0,4,2,0,2,3,13,1,0,2018,MF,1.8,1,0,0,4,0,2,3,6,0,0,6,2,2,50.0
2019,MF,20.3,60,34,28,26,6,26,53,49.1,27,24,0,24,29,89,20,2,2019,MF,20.3,6,0,0,16,0,6,29,34,0,0,163,8,8,50.0
2021,MF,30.0,152,75,80,60,12,103,152,67.8,49,57,9,48,46,198,58,0,2021,MF,30.0,13,0,0,52,2,5,46,75,1,0,195,40,31,56.3
2022,DF,17.7,34,19,21,11,2,19,35,54.3,16,37,26,11,26,60,111,0,2022,DF,17.7,5,0,0,20,1,13,26,19,1,0,88,30,18,62.5
2024,MF,0.1,0,0,0,0,0,0,0,,0,0,0,0,0,0,0,0,2024,MF,0.1,0,0,0,1,0,0,0,0,0,0,0,0,0,
2025,DF,34.9,106,68,48,42,16,57,90,63.3,33,47,15,32,43,149,96,0,2025,DF,34.9,10,0,0,32,1,49,43,68,1,1,142,25,23,52.1
2027,MF,0.2,0,0,0,0,0,0,0,,0,0,0,0,0,0,0,0,2027,MF,0.2,0,0,0,0,0,0,0,0,0,0,1,0,0,
2028,DF,1.3,6,3,6,0,0,6,7,85.7,1,3,2,1,2,8,7,0,2028,DF,1.3,0,0,0,1,0,0,2,3,0,0,7,5,4,55.6
2030,DF,12.6,21,14,16,5,0,13,17,76.5,4,15,9,6,6,27,60,0,2030,DF,12.6,6,0,0,13,0,0,6,14,0,1,51,25,18,58.1
2031,"MF,DF",2.9,5,4,2,3,0,0,4,0.0,4,1,0,1,4,9,2,0,2031,"MF,DF",2.9,1,0,0,6,0,2,4,4,0,0,16,4,7,36.4
2032,DF,11.9,21,11,9,9,3,11,22,50.0,11,17,5,12,10,31,30,1,2032,DF,11.9,0,0,0,7,1,92,10,11,0,0,56,9,21,30.0
2035,DF,30.0,20,11,11,9,0,7,14,50.0,7,23,11,12,33,53,104,0,2035,DF,30.0,9,1,1,37,0,1,33,11,0,0,137,60,37,61.9
2037,MF,29.3,57,36,30,22,5,33,77,42.9,44,26,7,19,29,86,43,1,2037,MF,29.3,15,1,0,31,0,82,29,36,1,0,184,14,3,82.4
2038,MF,28.7,43,30,16,21,6,20,46,43.5,26,25,9,16,21,64,29,3,2038,MF,28.7,4,0,0,18,0,57,21,30,0,0,173,24,10,70.6
2039,DF,16.2,30,15,11,12,7,15,26,57.7,11,21,5,16,17,47,26,0,2039,DF,16.2,4,0,0,14,0,42,17,15,3,0,124,24,20,54.5
2041,"MF,DF",8.8,14,11,9,4,1,5,10,50.0,5,9,3,6,11,25,9,0,2041,"MF,DF",8.8,3,0,0,10,0,2,11,11,0,0,56,7,8,46.7
2042,MF,22.8,28,17,9,18,1,14,31,45.2,17,29,6,23,16,44,34,0,2042,MF,22.8,3,0,0,20,6,10,16,17,0,0,124,36,31,53.7
2043,DF,5.0,11,7,9,2,0,9,14,64.3,5,7,3,4,3,14,19,0,2043,DF,5.0,3,0,0,9,0,0,3,7,0,0,12,7,13,35.0
2045,DF,10.7,21,14,9,10,2,14,24,58.3,10,13,2,11,10,31,21,0,2045,DF,10.7,2,1,0,14,2,40,10,14,0,0,51,6,8,42.9
2046,DF,17.9,13,8,10,3,0,8,18,44.4,10,15,9,6,6,19,44,0,2046,DF,17.9,4,0,0,8,0,11,6,8,0,0,71,9,17,34.6
2048,DF,11.2,34,24,21,11,2,14,37,37.8,23,14,3,11,9,43,33,0,2048,DF,11.2,4,0,0,18,1,32,9,24,0,0,60,7,10,41.2
2049,DF,4.5,7,5,4,3,0,3,4,75.0,1,5,3,2,4,11,27,0,2049,DF,4.5,1,0,0,4,0,0,4,5,0,0,19,13,6,68.4
2050,DF,15.5,10,7,8,2,0,6,11,54.5,5,15,7,8,24,34,78,0,2050,DF,15.5,6,1,1,11,0,0,24,7,0,0,70,29,19,60.4
2051,DF,18.6,34,21,21,11,2,20,24,83.3,4,25,15,10,32,66,44,1,2051,DF,18.6,6,0,0,23,2,24,32,21,0,0,68,35,27,56.5
2053,MF,13.6,28,16,10,14,4,17,33,51.5,16,13,3,10,17,45,12,0,2053,MF,13.6,6,0,0,20,0,18,17,16,0,0,75,10,13,43.5
2055,MF,20.0,54,32,28,19,7,19,46,41.3,27,25,7,18,15,69,21,0,2055,MF,20.0,6,1,0,45,1,20,15,32,0,0,110,20,19,51.3
2057,"DF,MF",0.1,0,0,0,0,0,0,0,,0,0,0,0,0,0,1,0,2057,"DF,MF",0.1,0,0,0,2,0,1,0,0,0,0,0,0,5,0.0
2058,MF,0.1,0,0,0,0,0,0,0,,0,0,0,0,0,0,0,0,2058,MF,0.1,0,0,0,0,0,0,0,0,0,0,1,0,0,
2059,DF,19.8,64,39,31,27,6,24,44,54.5,20,20,3,17,19,83,46,0,2059,DF,19.8,5,1,0,34,2,53,19,39,0,0,100,10,23,30.3
2060,DF,17.9,36,24,25,5,6,21,25,84.0,4,19,5,14,10,46,51,0,2060,DF,17.9,4,0,0,13,0,57,10,24,0,0,56,9,18,33.3
2061,DF,12.4,25,9,18,5,2,9,17,52.9,8,16,7,9,13,38,19,0,2061,DF,12.4,4,1,0,14,4,58,13,9,0,0,54,6,8,42.9
2064,DF,19.5,46,26,28,14,4,23,34,67.6,11,26,6,20,15,61,54,0,2064,DF,19.5,1,0,0,6,2,111,15,26,0,0,102,10,21,32.3
2070,MF,20.7,35,20,14,16,5,17,51,33.3,34,28,5,23,20,55,22,0,2070,MF,20.7,7,0,0,26,3,76,20,20,0,0,97,12,17,41.4
2071,DF,8.7,18,13,7,10,1,9,17,52.9,8,7,3,4,9,27,20,0,2071,DF,8.7,7,1,1,19,0,28,9,13,0,0,50,13,7,65.0
2072,DF,6.1,8,6,4,3,1,5,10,50.0,5,11,6,5,10,18,28,0,2072,DF,6.1,1,0,0,3,0,1,10,6,1,0,15,9,18,33.3
2073,DF,0.8,1,1,0,0,1,0,2,0.0,2,1,1,0,1,2,2,0,2073,DF,0.8,0,0,0,0,0,0,1,1,0,0,5,1,1,50.0
2076,DF,33.2,51,38,41,9,1,32,40,80.0,8,37,20,17,33,84,99,2,2076,DF,33.2,1,0,0,13,0,6,33,38,2,0,170,25,12,67.6
2077,DF,1.0,1,0,1,0,0,0,2,0.0,2,2,2,0,0,1,7,0,2077,DF,1.0,1,0,0,1,0,0,0,0,0,0,2,1,0,100.0
2080,MF,4.9,19,14,12,7,0,6,12,50.0,6,9,3,6,13,32,8,0,2080,MF,4.9,3,0,0,8,0,0,13,14,0,0,26,3,4,42.9
2084,MF,29.0,25,12,4,12,9,11,41,26.8,30,16,2,14,4,29,12,0,2084,MF,29.0,6,0,0,22,3,220,4,12,0,0,99,13,36,26.5
2085,DF,22.2,22,12,14,6,2,9,17,52.9,8,29,26,3,23,45,100,1,2085,DF,22.2,2,0,0,14,1,1,23,12,2,0,128,46,29,61.3
2087,DF,9.3,19,13,14,4,1,9,17,52.9,8,15,2,13,4,23,18,0,2087,DF,9.3,3,0,0,11,1,37,4,13,0,0,41,5,6,45.5
2091,"MF,DF",8.6,13,5,6,5,2,7,18,38.9,11,14,1,13,5,18,8,0,2091,"MF,DF",8.6,3,0,0,15,1,17,5,5,0,0,45,4,13,23.5
2094,DF,36.0,72,48,42,28,2,39,48,81.3,9,53,26,27,45,117,158,1,2094,DF,36.0,9,1,1,34,0,19,45,48,1,0,164,81,44,64.8
2101,DF,30.3,47,30,33,14,0,28,46,60.9,18,45,32,13,28,75,113,0,2101,DF,30.3,3,0,0,34,1,5,28,30,2,1,134,48,34,58.5
2102,MF,18.0,42,21,17,22,3,19,39,48.7,20,27,4,23,24,66,21,0,2102,MF,18.0,6,0,0,27,0,0,24,21,0,0,113,6,28,17.6
2104,MF,35.8,44,25,20,20,4,23,49,46.9,26,29,11,18,27,71,46,1,2104,MF,35.8,5,1,1,28,1,19,27,25,1,0,188,32,33,49.2
2110,DF,30.7,34,24,24,10,0,23,38,60.5,15,31,18,13,31,65,150,0,2110,DF,30.7,7,0,0,22,6,2,31,24,0,0,148,84,39,68.3
2111,DF,12.1,25,14,19,5,1,20,28,71.4,8,17,6,11,2,27,35,0,2111,DF,12.1,4,0,0,17,2,54,2,14,1,0,56,13,5,72.2
2113,DF,5.7,11,7,6,4,1,5,6,83.3,1,10,6,4,11,22,21,0,2113,DF,5.7,0,0,0,7,0,1,11,7,1,0,27,20,12,62.5
2115,MF,3.4,11,6,2,8,1,5,9,55.6,4,4,1,3,4,15,2,1,2115,MF,3.4,3,1,1,14,0,1,4,6,1,0,23,7,1,87.5
2116,MF,1.0,3,3,1,1,1,0,0,,0,0,0,0,2,5,2,0,2116,MF,1.0,0,0,0,3,0,2,2,3,0,0,8,0,0,
2118,DF,5.6,18,10,16,1,1,10,14,71.4,4,6,5,1,8,26,28,1,2118,DF,5.6,1,1,0,3,0,2,8,10,0,0,23,11,10,52.4
2123,DF,6.6,14,11,8,6,0,7,13,53.8,6,12,7,5,9,23,36,1,2123,DF,6.6,0,0,0,5,0,2,9,11,0,0,39,26,14,65.0
2126,DF,9.7,17,11,13,4,0,11,22,50.0,11,24,7,17,11,28,36,0,2126,DF,9.7,6,0,0,28,0,6,11,11,0,0,36,17,9,65.4
2127,DF,6.6,15,9,12,2,1,5,7,71.4,2,13,4,9,8,23,25,0,2127,DF,6.6,3,0,0,4,0,9,8,9,0,0,22,9,5,64.3
2129,DF,28.0,35,23,22,13,0,9,20,45.0,11,40,24,16,43,78,170,3,2129,DF,28.0,1,0,0,4,0,7,43,23,0,0,131,113,51,68.9
2132,DF,22.1,39,23,25,14,0,15,28,53.6,13,46,30,16,25,64,93,1,2132,DF,22.1,4,0,0,33,1,2,25,23,2,0,81,58,35,62.4
2133,MF,0.1,0,0,0,0,0,0,0,,0,0,0,0,0,0,0,0,2133,MF,0.1,0,0,0,0,0,0,0,0,0,0,1,0,0,
2135,MF,3.5,16,9,11,5,0,6,13,46.2,7,10,2,8,6,22,7,0,2135,MF,3.5,0,0,0,8,0,0,6,9,0,0,24,2,2,50.0
2136,MF,0.6,1,1,0,1,0,1,1,100.0,0,0,0,0,1,2,1,0,2136,MF,0.6,0,0,0,3,0,1,1,1,0,0,4,1,0,100.0
2137,MF,0.6,1,0,0,1,0,1,2,50.0,1,0,0,0,0,1,1,0,2137,MF,0.6,0,0,0,0,0,3,0,0,0,0,3,1,0,100.0
2140,MF,24.9,32,15,12,14,6,9,30,30.0,21,22,1,21,19,51,20,0,2140,MF,24.9,5,0,0,30,5,49,19,15,0,0,145,10,28,26.3
2141,DF,35.8,43,30,22,20,1,19,25,76.0,6,37,26,11,51,94,130,1,2141,DF,35.8,10,1,1,57,0,1,51,30,0,0,183,59,38,60.8
2143,DF,34.3,91,63,43,34,14,62,120,51.7,58,63,18,45,34,125,102,3,2143,DF,34.3,3,0,0,37,1,198,34,63,1,0,199,15,14,51.7
2146,DF,26.8,77,46,35,38,4,49,88,55.7,39,27,8,19,18,95,72,0,2146,DF,26.8,7,0,0,30,1,39,18,46,0,0,109,34,29,54.0
2148,MF,0.2,1,1,0,1,0,1,1,100.0,0,1,0,1,0,1,0,0,2148,MF,0.2,0,0,0,1,0,0,0,1,0,0,0,0,1,0.0
2149,"DF,MF",10.8,19,12,11,6,2,12,20,60.0,8,14,4,10,7,26,21,0,2149,"DF,MF",10.8,3,0,0,16,0,41,7,12,0,0,50,5,9,35.7
2150,"MF,DF",16.1,45,28,11,23,11,23,42,54.8,19,32,5,27,23,68,27,0,2150,"MF,DF",16.1,1,0,0,29,0,10,23,28,1,0,102,28,30,48.3
2151,MF,21.9,45,25,15,27,3,26,42,61.9,16,29,6,23,15,60,26,1,2151,MF,21.9,4,0,0,19,0,15,15,25,0,0,115,9,13,40.9
2153,MF,1.0,0,0,0,0,0,0,1,0.0,1,2,1,1,3,3,1,0,2153,MF,1.0,0,0,0,0,0,0,3,0,0,0,5,0,0,
2154,MF,23.8,32,18,11,15,6,14,32,43.8,18,22,6,16,22,54,36,0,2154,MF,23.8,10,1,1,33,1,10,22,18,0,0,127,16,23,41.0
2156,DF,20.9,47,23,35,8,4,22,39,56.4,17,20,8,12,15,62,83,1,2156,DF,20.9,2,0,0,21,0,68,15,23,0,0,93,25,20,55.6
2157,"DF,MF",0.5,5,3,2,2,1,1,2,50.0,1,2,0,2,0,5,0,0,2157,"DF,MF",0.5,0,0,0,2,0,1,0,3,0,0,4,1,1,50.0
2162,DF,13.2,25,22,17,7,1,14,20,70.0,6,16,8,8,17,42,39,1,2162,DF,13.2,1,0,0,10,0,0,17,22,1,0,72,45,22,67.2
2163,MF,0.1,1,1,1,0,0,0,0,,0,0,0,0,0,1,0,0,2163,MF,0.1,0,0,0,0,0,0,0,1,0,0,1,0,1,0.0
2164,MF,29.5,58,39,22,30,6,30,45,66.7,15,26,6,20,25,83,34,0,2164,MF,29.5,8,0,0,44,6,45,25,39,0,0,150,54,40,57.4
2165,MF,9.1,10,4,6,4,0,0,9,0.0,9,16,7,9,7,17,22,0,2165,MF,9.1,1,0,0,6,0,2,7,4,0,0,50,12,13,48.0
2167,"MF,DF",3.9,4,2,1,3,0,1,4,25.0,3,2,0,2,3,7,3,0,2167,"MF,DF",3.9,0,0,0,1,0,20,3,2,0,0,13,3,1,75.0
2168,DF,6.3,8,7,7,1,0,6,6,100.0,0,8,8,0,11,19,48,0,2168,DF,6.3,2,0,0,7,0,0,11,7,0,0,13,14,9,60.9
2171,MF,13.4,44,31,13,27,4,13,30,43.3,17,27,1,26,11,55,13,0,2171,MF,13.4,4,0,0,31,2,38,11,31,0,1,70,9,20,31.0
2173,DF,24.4,30,23,18,12,0,17,23,73.9,6,44,30,14,37,67,104,2,2173,DF,24.4,6,1,1,32,3,2,37,23,0,0,107,123,59,67.6
2177,MF,15.8,30,16,9,12,9,11,19,57.9,8,16,5,11,14,44,12,0,2177,MF,15.8,6,0,0,16,1,131,14,16,0,0,117,12,13,48.0
2178,MF,33.0,68,41,32,29,7,37,96,38.5,59,54,13,41,44,112,44,0,2178,MF,33.0,13,0,0,42,0,14,44,41,1,0,225,29,27,51.8
2184,DF,28.0,45,30,32,11,2,27,40,67.5,13,35,30,5,41,86,156,0,2184,DF,28.0,7,1,0,27,9,2,41,30,1,1,143,80,41,66.1
2188,DF,22.9,14,10,11,1,2,8,13,61.5,5,25,11,14,29,43,64,0,2188,DF,22.9,14,0,0,32,1,13,29,10,0,0,99,40,38,51.3
2189,"MF,DF",5.3,16,11,7,9,0,7,16,43.8,9,9,1,8,3,19,14,0,2189,"MF,DF",5.3,3,0,0,11,0,10,3,11,0,0,16,6,4,60.0
2192,DF,0.8,3,2,2,1,0,2,2,100.0,0,2,0,2,2,5,8,0,2192,DF,0.8,1,0,0,2,0,0,2,2,0,0,10,1,0,100.0
2196,"DF,MF",7.0,12,4,6,5,1,8,15,53.3,7,4,1,3,0,12,12,0,2196,"DF,MF",7.0,1,0,0,2,0,18,0,4,0,0,39,6,7,46.2
2198,DF,30.4,58,35,24,29,5,34,58,58.6,24,51,9,42,27,85,82,2,2198,DF,30.4,6,0,0,28,4,306,27,35,0,0,169,27,20,57.4
2201,DF,16.7,20,9,13,5,2,9,18,50.0,9,23,15,8,25,45,61,2,2201,DF,16.7,4,1,1,8,1,1,25,9,2,0,79,25,19,56.8
2204,MF,14.7,29,18,9,17,3,13,31,41.9,18,19,9,10,11,40,24,0,2204,MF,14.7,6,0,0,26,0,19,11,18,0,0,72,9,13,40.9
2205,DF,4.6,13,8,6,2,5,8,17,47.1,9,10,0,10,5,18,7,0,2205,DF,4.6,3,0,0,4,3,29,5,8,0,0,21,5,9,35.7
2206,DF,12.4,45,20,26,18,1,24,40,60.0,16,23,6,17,16,61,41,1,2206,DF,12.4,4,1,0,10,1,72,16,20,1,0,75,14,20,41.2
2208,MF,31.3,46,25,10,31,5,21,43,48.8,22,26,8,18,18,64,26,0,2208,MF,31.3,8,0,0,21,1,39,18,25,0,0,136,8,18,30.8
2211,MF,23.7,61,36,28,29,4,28,55,50.9,27,61,20,41,44,105,31,1,2211,MF,23.7,2,0,0,26,2,15,44,36,0,0,171,13,26,33.3
2216,MF,22.1,30,19,14,13,3,18,36,50.0,18,32,7,25,20,50,20,0,2216,MF,22.1,4,0,0,20,2,21,20,19,0,0,125,27,26,50.9
2219,DF,24.0,35,24,17,18,0,17,27,63.0,10,23,14,9,23,58,108,0,2219,DF,24.0,1,0,0,15,1,0,23,24,1,0,110,44,38,53.7
2220,DF,24.7,32,22,24,8,0,16,31,51.6,15,25,15,10,35,67,116,5,2220,DF,24.7,6,1,0,27,1,2,35,22,0,1,124,39,17,69.6
2222,MF,26.6,33,18,17,12,4,15,23,65.2,8,21,3,18,27,60,25,0,2222,MF,26.6,8,1,1,37,3,54,27,18,0,0,125,17,25,40.5
2223,MF,35.8,83,51,37,38,8,32,57,56.1,25,37,11,26,44,127,52,0,2223,MF,35.8,5,0,0,34,2,60,44,51,2,0,178,39,43,47.6
2224,"DF,MF",23.3,46,28,21,22,3,20,30,66.7,10,32,12,20,27,73,109,0,2224,"DF,MF",23.3,3,0,0,12,1,1,27,28,1,0,88,61,44,58.1
2225,MF,15.0,33,23,12,18,3,10,22,45.5,12,26,5,21,15,48,30,0,2225,MF,15.0,4,0,0,30,0,13,15,23,0,0,86,17,11,60.7
2228,DF,28.2,64,48,32,23,9,41,76,53.9,35,25,8,17,41,105,76,0,2228,DF,28.2,10,0,0,32,2,130,41,48,0,0,164,29,20,59.2
2229,DF,8.4,22,13,16,5,1,15,24,62.5,9,11,3,8,11,33,26,0,2229,DF,8.4,2,0,0,10,0,8,11,13,0,0,57,11,14,44.0
2230,MF,4.1,13,7,2,9,2,6,11,54.5,5,3,1,2,5,18,2,0,2230,MF,4.1,0,0,0,10,0,9,5,7,0,0,24,6,3,66.7
2235,"DF,MF",17.0,30,19,18,4,8,18,46,39.1,28,19,0,19,9,39,20,0,2235,"DF,MF",17.0,1,0,0,11,9,65,9,19,1,0,98,5,16,23.8
2236,MF,1.5,2,2,1,1,0,0,4,0.0,4,0,0,0,0,2,1,0,2236,MF,1.5,0,0,0,1,0,1,0,2,0,0,3,0,1,0.0
2237,"DF,MF",9.0,15,9,9,6,0,9,12,75.0,3,9,2,7,10,25,23,0,2237,"DF,MF",9.0,2,0,0,12,0,39,10,9,0,0,67,9,7,56.3
2239,DF,0.0,0,0,0,0,0,0,0,,0,0,0,0,0,0,0,0,2239,DF,0.0,0,0,0,0,0,0,0,0,0,0,0,0,0,
2240,"MF,DF",9.6,15,10,4,10,1,3,11,27.3,8,7,2,5,8,23,7,1,2240,"MF,DF",9.6,4,0,0,8,1,9,8,10,0,0,44,12,11,52.2
2241,MF,26.5,61,33,28,23,10,25,50,50.0,25,43,9,34,51,112,43,0,2241,MF,26.5,11,0,0,38,2,67,51,33,0,0,163,38,29,56.7
2242,DF,9.1,12,5,6,4,2,8,17,47.1,9,8,6,2,4,16,25,2,2242,DF,9.1,5,1,1,5,3,10,4,5,0,0,40,6,7,46.2
2243,DF,18.8,35,24,21,11,3,26,43,60.5,17,20,6,14,13,48,40,0,2243,DF,18.8,2,0,0,9,3,184,13,24,0,0,104,14,12,53.8
2244,DF,36.3,93,58,60,26,7,52,110,47.3,58,56,8,48,80,173,117,3,2244,DF,36.3,6,0,0,34,3,132,80,58,0,2,227,42,27,60.9
2245,DF,32.1,43,28,29,14,0,25,39,64.1,14,49,33,16,33,76,132,2,2245,DF,32.1,10,0,0,19,1,12,33,28,0,2,135,69,45,60.5
2246,MF,22.0,52,36,17,29,6,30,53,56.6,23,29,6,23,17,69,23,1,2246,MF,22.0,5,0,0,48,1,25,17,36,0,0,147,9,22,29.0
2247,MF,0.7,6,4,0,5,1,4,6,66.7,2,0,0,0,1,7,1,0,2247,MF,0.7,0,0,0,0,0,1,1,4,0,0,10,2,3,40.0
2249,MF,32.6,70,43,25,33,12,29,60,48.3,31,32,8,24,26,96,41,4,2249,MF,32.6,8,1,0,41,6,12,26,43,0,0,235,54,22,71.1
2253,MF,2.9,6,3,1,3,2,1,3,33.3,2,4,2,2,1,7,2,0,2253,MF,2.9,1,0,0,4,0,9,1,3,0,0,8,0,2,0.0
2254,MF,29.1,47,24,21,20,6,21,45,46.7,24,34,5,29,15,62,21,0,2254,MF,29.1,9,0,0,61,6,169,15,24,0,0,151,23,50,31.5
2255,MF,20.5,53,30,21,24,8,34,55,61.8,21,27,6,21,29,82,44,0,2255,MF,20.5,6,0,0,23,4,6,29,30,1,0,155,20,14,58.8
2257,MF,35.7,52,32,22,25,5,24,67,35.8,43,39,3,36,28,80,23,1,2257,MF,35.7,8,0,0,23,1,26,28,32,2,0,231,22,46,32.4
2258,MF,3.3,6,3,3,1,2,3,9,33.3,6,8,0,8,4,10,0,0,2258,MF,3.3,2,0,0,15,0,11,4,3,0,0,9,1,8,11.1
2259,DF,30.8,45,26,21,22,2,28,45,62.2,17,22,9,13,24,69,64,2,2259,DF,30.8,4,0,0,25,1,57,24,26,0,0,112,41,29,58.6
2261,DF,22.1,48,31,34,9,5,27,54,50.0,27,15,3,12,19,67,71,0,2261,DF,22.1,1,0,0,10,3,62,19,31,0,0,82,14,27,34.1
2262,DF,10.1,14,6,7,5,2,10,14,71.4,4,16,5,11,5,19,23,1,2262,DF,10.1,0,0,0,7,0,27,5,6,0,0,55,7,14,33.3
2265,DF,26.8,25,18,14,11,0,16,24,66.7,8,29,17,12,29,54,115,0,2265,DF,26.8,9,0,0,34,1,1,29,18,0,0,120,76,54,58.5
2266,DF,30.2,35,15,23,11,1,15,20,75.0,5,51,36,15,29,64,147,0,2266,DF,30.2,6,0,0,24,0,1,29,15,0,0,99,97,78,55.4
2267,DF,2.9,11,5,8,1,2,7,12,58.3,5,3,0,3,1,12,11,0,2267,DF,2.9,1,0,0,2,0,11,1,5,0,0,27,1,2,33.3
2268,DF,31.0,66,40,35,25,6,32,44,72.7,12,46,22,24,44,110,106,1,2268,DF,31.0,7,1,0,31,1,3,44,40,2,1,189,87,39,69.0
2272,MF,10.4,34,20,17,14,3,13,24,54.2,11,12,2,10,10,44,18,0,2272,MF,10.4,4,0,0,15,0,6,10,20,0,0,62,14,19,42.4
2273,MF,9.5,23,12,9,12,2,14,26,53.8,12,16,4,12,15,38,18,0,2273,MF,9.5,2,0,0,13,0,3,15,12,0,0,55,9,6,60.0
2274,"DF,MF",0.8,1,0,0,1,0,0,1,0.0,1,1,0,1,1,2,3,0,2274,"DF,MF",0.8,0,0,0,0,0,2,1,0,0,0,2,1,0,100.0
2275,"MF,DF",28.9,80,43,36,32,12,35,82,42.7,47,36,10,26,40,120,54,0,2275,"MF,DF",28.9,10,0,0,43,3,16,40,43,1,0,164,35,27,56.5
2276,MF,0.1,0,0,0,0,0,0,0,,0,0,0,0,0,0,0,0,2276,MF,0.1,0,0,0,1,0,0,0,0,0,0,0,0,0,
2278,"MF,DF",22.3,36,25,15,16,5,23,34,67.6,11,27,13,14,29,65,39,0,2278,"MF,DF",22.3,4,0,0,18,1,6,29,25,1,0,92,35,22,61.4
2279,"DF,MF",0.6,1,0,1,0,0,0,0,,0,1,0,1,2,3,5,0,2279,"DF,MF",0.6,0,0,0,0,0,0,2,0,0,0,3,1,0,100.0
2281,MF,4.3,7,2,4,2,1,2,8,25.0,6,4,2,2,3,10,2,0,2281,MF,4.3,0,0,0,4,0,12,3,2,1,0,32,0,2,0.0
2282,DF,11.2,21,12,14,5,2,13,21,61.9,8,14,8,6,8,29,28,0,2282,DF,11.2,3,0,0,9,1,3,8,12,1,0,58,19,27,41.3
2283,DF,8.4,16,9,6,7,3,8,12,66.7,4,13,4,9,5,21,26,0,2283,DF,8.4,2,0,0,4,0,21,5,9,0,0,52,9,8,52.9
2284,MF,14.6,46,28,25,17,4,16,36,44.4,20,27,6,21,23,69,29,0,2284,MF,14.6,6,0,0,38,0,20,23,28,0,0,99,11,9,55.0
2285,DF,28.9,33,27,17,14,2,16,32,50.0,16,24,10,14,20,53,90,0,2285,DF,28.9,5,0,0,19,2,4,20,27,1,0,140,79,46,63.2
2286,DF,16.8,25,15,11,10,4,10,18,55.6,8,18,15,3,24,49,68,2,2286,DF,16.8,7,1,1,23,0,2,24,15,1,0,80,34,27,55.7
2287,MF,12.2,13,5,6,6,1,5,9,55.6,4,15,7,8,9,22,16,3,2287,MF,12.2,1,0,0,9,0,11,9,5,0,0,54,12,19,38.7
2288,DF,30.1,26,15,18,4,4,16,20,80.0,4,27,20,7,11,37,89,0,2288,DF,30.1,7,0,0,26,1,4,11,15,0,0,124,49,23,68.1
2289,MF,0.1,1,0,0,0,1,0,0,,0,0,0,0,0,1,0,0,2289,MF,0.1,0,0,0,0,0,0,0,0,0,0,0,0,0,
2290,"MF,DF",0.2,0,0,0,0,0,0,0,,0,0,0,0,0,0,0,0,2290,"MF,DF",0.2,0,0,0,0,0,0,0,0,0,0,2,0,0,
2291,DF,13.2,11,9,7,3,1,4,5,80.0,1,11,4,7,9,20,42,0,2291,DF,13.2,2,0,0,15,0,1,9,9,0,0,44,25,24,51.0
2292,DF,27.2,29,15,14,7,8,16,30,53.3,14,46,4,42,23,52,44,0,2292,DF,27.2,3,0,0,21,2,101,23,15,1,0,171,49,36,57.6
2293,DF,13.4,27,15,17,5,5,14,21,66.7,7,17,2,15,15,42,19,0,2293,DF,13.4,7,1,1,16,1,62,15,15,1,0,57,10,27,27.0
2295,MF,13.3,34,23,17,14,3,23,42,54.8,19,8,2,6,11,45,21,2,2295,MF,13.3,3,0,0,6,1,11,11,23,0,0,83,4,8,33.3
2296,MF,27.7,83,46,43,36,4,38,84,45.2,46,24,6,18,28,111,43,1,2296,MF,27.7,9,0,0,42,0,17,28,46,1,0,177,32,30,51.6
2297,DF,19.6,41,23,26,11,4,27,47,57.4,20,31,7,24,10,51,35,3,2297,DF,19.6,3,0,0,18,0,40,10,23,0,0,121,8,12,40.0
2300,DF,11.6,16,11,12,3,1,8,12,66.7,4,6,3,3,11,27,27,0,2300,DF,11.6,2,0,0,9,0,27,11,11,0,0,63,10,13,43.5
2302,DF,27.0,50,24,28,19,3,15,46,32.6,31,27,6,21,23,73,35,0,2302,DF,27.0,5,0,0,36,4,99,23,24,0,0,91,16,22,42.1
2303,MF,21.8,39,24,18,20,1,23,42,54.8,19,31,12,19,12,51,34,0,2303,MF,21.8,3,1,0,15,1,30,12,24,0,0,89,6,20,23.1
2304,DF,15.4,28,16,13,10,5,21,32,65.6,11,19,7,12,24,52,37,0,2304,DF,15.4,0,0,0,8,0,27,24,16,0,1,107,15,23,39.5
2308,MF,0.2,3,3,2,0,1,1,3,33.3,2,0,0,0,0,3,0,0,2308,MF,0.2,0,0,0,0,0,1,0,3,0,0,3,0,0,
2309,DF,11.7,34,22,23,9,2,15,25,60.0,10,13,9,4,15,49,67,0,2309,DF,11.7,5,0,0,19,0,1,15,22,0,0,51,20,10,66.7
2311,DF,3.8,17,7,10,6,1,11,19,57.9,8,9,4,5,3,20,15,0,2311,DF,3.8,1,0,0,3,0,7,3,7,0,0,23,3,4,42.9
2313,DF,0.1,1,1,1,0,0,1,1,100.0,0,0,0,0,0,1,1,0,2313,DF,0.1,0,0,0,0,0,0,0,1,0,0,0,1,1,50.0
2317,DF,17.8,41,23,26,12,3,22,36,61.1,14,25,14,11,26,67,91,1,2317,DF,17.8,10,0,0,32,1,7,26,23,0,0,81,66,40,62.3
2318,DF,38.0,41,26,28,12,1,20,27,74.1,7,32,17,15,29,70,81,3,2318,DF,38.0,4,0,0,22,0,3,29,26,1,0,213,72,49,59.5
2319,DF,11.5,27,12,11,13,3,17,26,65.4,9,21,12,9,22,49,44,0,2319,DF,11.5,2,0,0,12,1,1,22,12,0,0,65,36,21,63.2
2321,DF,17.4,22,10,13,6,3,13,20,65.0,7,21,15,6,21,43,57,0,2321,DF,17.4,3,0,0,18,3,9,21,10,0,1,82,29,21,58.0
2322,MF,0.3,0,0,0,0,0,0,4,0.0,4,0,0,0,1,1,0,0,2322,MF,0.3,0,0,0,0,0,0,1,0,0,0,1,0,0,
2323,MF,26.4,40,19,18,18,4,16,39,41.0,23,26,6,20,10,50,25,0,2323,MF,26.4,3,0,0,29,0,124,10,19,1,0,142,14,35,28.6
2324,MF,1.0,5,3,2,2,1,5,6,83.3,1,0,0,0,3,8,1,0,2324,MF,1.0,0,0,0,2,0,0,3,3,0,0,6,3,2,60.0
2325,MF,0.0,0,0,0,0,0,0,0,,0,0,0,0,1,1,0,0,2325,MF,0.0,0,0,0,0,0,0,1,0,0,0,0,0,0,
2328,MF,14.5,29,18,14,12,3,17,24,70.8,7,23,13,10,11,40,14,0,2328,MF,14.5,4,0,0,18,0,13,11,18,0,0,64,15,9,62.5
2329,"DF,MF",11.5,12,5,8,1,3,6,11,54.5,5,15,7,8,11,23,28,0,2329,"DF,MF",11.5,4,0,0,9,0,28,11,5,1,0,38,23,12,65.7
2330,MF,1.7,3,2,2,1,0,1,4,25.0,3,3,2,1,2,5,1,0,2330,MF,1.7,1,1,0,8,0,1,2,2,0,0,5,3,4,42.9
2332,MF,21.9,19,11,3,10,6,8,21,38.1,13,5,1,4,10,29,5,0,2332,MF,21.9,5,2,1,30,3,30,10,11,0,0,107,24,18,57.1
2333,MF,1.6,2,1,1,1,0,2,3,66.7,1,2,0,2,0,2,1,0,2333,MF,1.6,2,0,0,6,0,4,0,1,1,0,5,1,2,33.3
2334,DF,25.5,29,18,15,8,6,12,24,50.0,12,32,4,28,13,42,64,0,2334,DF,25.5,8,0,0,27,5,82,13,18,1,0,97,19,18,51.4
2336,MF,16.1,25,11,13,10,2,11,32,34.4,21,24,5,19,13,38,13,0,2336,MF,16.1,3,0,0,26,1,36,13,11,0,0,115,7,19,26.9
2337,DF,0.9,0,0,0,0,0,0,0,,0,3,2,1,1,1,2,0,2337,DF,0.9,1,0,0,2,0,0,1,0,0,0,4,3,1,75.0
2338,DF,13.1,56,35,34,18,4,34,58,58.6,24,24,7,17,12,68,36,0,2338,DF,13.1,2,0,0,11,1,61,12,35,2,0,67,14,15,48.3
2339,"DF,MF",19.7,54,28,21,25,8,31,55,56.4,24,23,3,20,19,73,65,0,2339,"DF,MF",19.7,3,0,0,21,0,57,19,28,0,0,95,9,21,30.0
2343,DF,8.0,13,7,7,6,0,4,5,80.0,1,13,7,6,15,28,23,0,2343,DF,8.0,1,0,0,17,0,5,15,7,0,0,34,12,9,57.1
2346,DF,9.4,19,12,16,2,1,6,7,85.7,1,14,9,5,8,27,64,0,2346,DF,9.4,1,0,0,9,1,8,8,12,0,0,28,13,12,52.0
2347,DF,29.9,53,33,27,23,3,24,40,60.0,16,35,18,17,66,119,93,2,2347,DF,29.9,8,0,0,54,0,15,66,33,1,1,151,50,42,54.3
2348,MF,11.5,42,23,25,13,4,12,29,41.4,17,24,7,17,16,58,21,0,2348,MF,11.5,6,0,0,22,2,2,16,23,0,0,70,8,16,33.3
2349,MF,21.8,26,19,12,7,7,12,31,38.7,19,34,5,29,20,46,16,0,2349,MF,21.8,4,0,0,30,2,114,20,19,1,0,125,8,18,30.8
2351,MF,21.4,52,33,21,25,6,29,46,63.0,17,15,6,9,34,86,33,1,2351,MF,21.4,3,0,0,23,1,0,34,33,0,0,125,38,36,51.4
2352,MF,7.3,17,8,8,5,4,4,7,57.1,3,3,0,3,0,17,8,0,2352,MF,7.3,4,0,0,17,0,4,0,8,0,0,29,6,7,46.2
2353,MF,0.1,0,0,0,0,0,0,0,,0,1,0,1,0,0,0,0,2353,MF,0.1,0,0,0,0,0,0,0,0,0,0,0,0,0,
2354,MF,9.2,29,18,15,13,1,17,26,65.4,9,8,0,8,10,39,11,1,2354,MF,9.2,4,0,0,10,1,3,10,18,0,0,61,12,9,57.1
2355,DF,26.3,63,42,31,19,13,30,52,57.7,22,24,5,19,15,78,37,0,2355,DF,26.3,6,0,0,38,0,83,15,42,1,0,127,12,23,34.3
2356,DF,0.3,0,0,0,0,0,0,1,0.0,1,0,0,0,0,0,4,0,2356,DF,0.3,0,0,0,0,0,0,0,0,0,0,0,1,0,100.0
2361,DF,1.2,2,0,1,1,0,2,2,100.0,0,3,0,3,0,2,1,0,2361,DF,1.2,0,0,0,0,0,1,0,0,0,0,3,1,1,50.0
2363,DF,0.1,0,0,0,0,0,0,0,,0,0,0,0,0,0,0,0,2363,DF,0.1,0,0,0,0,0,0,0,0,0,0,0,0,0,
2365,MF,30.7,37,20,16,15,6,14,63,22.2,49,36,8,28,33,70,28,1,2365,MF,30.7,8,1,0,41,3,231,33,20,0,0,196,21,32,39.6
2366,DF,18.1,27,19,16,7,4,15,30,50.0,15,29,15,14,27,54,61,1,2366,DF,18.1,7,1,1,16,1,3,27,19,0,0,77,46,32,59.0
2368,"DF,MF",0.3,1,1,0,1,0,1,3,33.3,2,0,0,0,0,1,1,0,2368,"DF,MF",0.3,0,0,0,1,0,0,0,1,0,0,1,0,1,0.0
2369,DF,4.0,9,7,4,5,0,3,3,100.0,0,8,5,3,3,12,22,0,2369,DF,4.0,2,0,0,10,0,0,3,7,1,0,22,10,10,50.0
2370,DF,24.8,41,28,21,17,3,23,40,57.5,17,31,11,20,18,59,78,2,2370,DF,24.8,4,0,0,16,1,46,18,28,0,0,92,22,32,40.7
2371,DF,28.3,53,33,29,19,5,19,40,47.5,21,44,17,27,59,112,71,0,2371,DF,28.3,3,0,0,48,4,5,59,33,2,0,163,80,40,66.7
2375,MF,13.5,29,16,9,15,5,11,20,55.0,9,25,4,21,20,49,25,0,2375,MF,13.5,1,1,0,22,2,18,20,16,0,0,74,22,24,47.8
2376,DF,33.9,42,24,27,13,2,18,40,45.0,22,50,38,12,36,78,133,1,2376,DF,33.9,5,0,0,38,0,8,36,24,0,0,174,69,70,49.6
2379,MF,27.5,81,50,35,38,8,21,53,39.6,32,41,8,33,19,100,27,0,2379,MF,27.5,7,0,0,34,2,14,19,50,0,0,203,23,18,56.1
2380,DF,24.3,42,22,26,14,2,25,30,83.3,5,33,23,10,33,75,104,2,2380,DF,24.3,9,0,0,36,0,12,33,22,2,2,144,112,70,61.5
2381,DF,31.8,70,50,36,27,7,41,65,63.1,24,52,25,27,45,115,101,3,2381,DF,31.8,4,0,0,17,0,8,45,50,0,1,245,58,41,58.6
2384,DF,0.8,2,2,2,0,0,2,4,50.0,2,1,0,1,1,3,2,0,2384,DF,0.8,0,0,0,1,0,2,1,2,0,0,11,1,1,50.0
2385,MF,14.1,36,21,13,19,4,16,33,48.5,17,14,7,7,4,40,13,0,2385,MF,14.1,4,0,0,15,0,50,4,21,0,0,92,7,6,53.8
2386,DF,12.8,27,15,20,7,0,17,34,50.0,17,19,4,15,7,34,29,0,2386,DF,12.8,5,0,0,9,0,40,7,15,0,0,59,14,22,38.9
2387,MF,2.6,4,1,2,1,1,1,3,33.3,2,1,0,1,4,8,5,0,2387,MF,2.6,1,0,0,2,0,4,4,1,0,0,25,1,3,25.0
2388,MF,22.2,48,26,26,20,2,21,42,50.0,21,37,7,30,26,74,57,0,2388,MF,22.2,3,0,0,14,1,7,26,26,0,0,108,39,39,50.0
2390,DF,8.6,20,12,11,8,1,3,9,33.3,6,10,2,8,9,29,23,0,2390,DF,8.6,2,0,0,8,0,2,9,12,1,0,49,15,9,62.5
2393,MF,11.3,24,15,8,10,6,12,28,42.9,16,14,4,10,12,36,18,2,2393,MF,11.3,3,0,0,20,1,36,12,15,0,0,63,14,22,38.9
2396,MF,4.7,5,3,1,4,0,3,4,75.0,1,1,0,1,1,6,0,0,2396,MF,4.7,1,0,0,9,0,2,1,3,0,0,22,3,10,23.1
2398,DF,10.5,14,10,10,4,0,10,16,62.5,6,8,4,4,13,27,43,0,2398,DF,10.5,2,0,0,14,1,0,13,10,1,0,49,17,18,48.6
2399,DF,6.6,21,9,17,3,1,14,19,73.7,5,11,3,8,10,31,13,0,2399,DF,6.6,3,0,0,8,1,6,10,9,0,0,33,7,5,58.3
2400,DF,12.6,32,24,17,15,0,24,31,77.4,7,15,7,8,25,57,37,0,2400,DF,12.6,5,1,0,20,0,4,25,24,1,0,107,15,8,65.2
2401,MF,8.0,33,18,16,15,2,16,25,64.0,9,12,2,10,8,41,15,0,2401,MF,8.0,1,0,0,5,0,4,8,18,0,1,50,6,8,42.9
2406,"DF,MF",34.3,79,48,52,19,8,38,64,59.4,26,44,8,36,36,115,85,1,2406,"DF,MF",34.3,10,1,0,48,1,80,36,48,2,0,188,22,27,44.9
2409,"DF,MF",23.8,72,53,38,25,9,42,68,61.8,26,40,13,27,41,113,68,0,2409,"DF,MF",23.8,5,1,1,36,0,79,41,53,1,0,83,41,28,59.4
2410,DF,24.9,55,32,28,23,4,24,56,42.9,32,50,23,27,35,90,109,1,2410,DF,24.9,13,0,0,41,0,25,35,32,0,0,164,37,40,48.1
2411,MF,0.5,1,1,0,1,0,1,3,33.3,2,1,0,1,1,2,0,0,2411,MF,0.5,0,0,0,0,0,1,1,1,0,0,3,0,0,
2412,MF,18.4,51,39,24,23,4,22,45,48.9,23,29,7,22,20,71,25,1,2412,MF,18.4,7,0,0,40,0,9,20,39,0,0,109,22,21,51.2
2416,"DF,MF",0.3,1,1,1,0,0,1,2,50.0,1,0,0,0,0,1,0,0,2416,"DF,MF",0.3,0,0,0,0,0,1,0,1,0,0,1,0,0,
2418,DF,10.7,11,8,7,3,1,9,15,60.0,6,18,11,7,6,17,39,0,2418,DF,10.7,6,0,0,14,0,33,6,8,0,0,59,13,10,56.5
2422,MF,0.2,2,0,0,2,0,1,2,50.0,1,1,0,1,2,4,0,0,2422,MF,0.2,0,0,0,1,0,0,2,0,0,0,2,0,1,0.0
2423,MF,25.1,41,24,15,20,6,27,77,35.1,50,37,13,24,27,68,33,0,2423,MF,25.1,8,0,0,52,3,111,27,24,0,0,137,30,32,48.4
2424,DF,10.1,27,11,21,6,0,8,20,40.0,12,16,10,6,21,48,29,1,2424,DF,10.1,1,0,0,16,0,1,21,11,2,0,59,13,11,54.2
2425,DF,20.1,43,19,28,8,7,26,42,61.9,16,33,15,18,22,65,64,0,2425,DF,20.1,2,1,0,29,4,37,22,19,0,0,107,32,37,46.4
2428,DF,6.9,13,7,3,7,3,6,9,66.7,3,8,2,6,6,19,9,0,2428,DF,6.9,0,0,0,2,1,36,6,7,0,0,37,2,5,28.6
2431,DF,28.1,29,15,22,6,1,20,34,58.8,14,33,24,9,26,55,153,4,2431,DF,28.1,4,0,0,10,1,4,26,15,0,0,140,51,26,66.2
2433,DF,23.8,48,29,28,19,1,32,44,72.7,12,36,14,22,29,77,69,0,2433,DF,23.8,8,0,0,35,3,18,29,29,1,0,113,60,36,62.5
2436,DF,1.6,1,1,1,0,0,0,0,,0,5,4,1,0,1,3,0,2436,DF,1.6,0,0,0,2,0,0,0,1,0,0,4,2,2,50.0
2439,MF,29.5,30,17,10,11,9,15,31,48.4,16,23,0,23,16,46,4,0,2439,MF,29.5,11,1,1,32,1,76,16,17,0,0,167,19,17,52.8
2440,DF,24.3,34,25,18,14,2,17,26,65.4,9,27,14,13,51,85,81,2,2440,DF,24.3,8,1,0,36,2,21,51,25,0,1,199,63,29,68.5
2442,DF,4.2,11,5,6,5,0,2,8,25.0,6,5,3,2,6,17,9,0,2442,DF,4.2,0,1,0,4,0,5,6,5,1,0,17,5,1,83.3
2443,"DF,MF",10.0,27,18,22,5,0,13,24,54.2,11,13,5,8,12,39,32,0,2443,"DF,MF",10.0,1,0,0,13,0,4,12,18,0,0,61,17,25,40.5
2445,MF,18.2,47,33,13,25,9,23,30,76.7,7,21,8,13,19,66,30,0,2445,MF,18.2,7,0,0,44,0,2,19,33,0,0,108,29,20,59.2
2446,MF,20.2,27,16,13,8,6,12,25,48.0,13,8,2,6,12,39,31,0,2446,MF,20.2,7,0,0,40,2,18,12,16,0,0,114,14,23,37.8
2449,MF,24.1,44,24,18,19,7,19,36,52.8,17,33,4,29,39,83,47,2,2449,MF,24.1,1,0,0,14,3,4,39,24,0,0,160,31,25,55.4
2450,"MF,DF",7.9,18,12,9,6,3,11,18,61.1,7,12,1,11,3,21,9,0,2450,"MF,DF",7.9,3,0,0,8,0,1,3,12,0,0,36,3,10,23.1
2451,DF,18.1,24,12,13,10,1,6,11,54.5,5,18,12,6,16,40,65,0,2451,DF,18.1,3,0,0,12,1,2,16,12,0,0,78,58,25,69.9
2454,DF,18.1,24,18,17,7,0,14,22,63.6,8,19,10,9,12,36,51,2,2454,DF,18.1,1,0,0,14,0,1,12,18,0,0,111,25,26,49.0
2456,DF,4.3,1,1,1,0,0,1,4,25.0,3,6,5,1,5,6,8,0,2456,DF,4.3,0,0,0,1,0,0,5,1,0,0,22,22,7,75.9
2457,DF,23.9,37,23,18,11,8,19,39,48.7,20,28,11,17,21,58,62,0,2457,DF,23.9,6,0,0,30,1,39,21,23,2,0,92,18,22,45.0
2458,MF,3.9,4,1,2,2,0,2,4,50.0,2,3,1,2,3,7,1,0,2458,MF,3.9,0,0,0,5,0,1,3,1,0,0,15,3,5,37.5
2459,DF,3.9,7,3,7,0,0,4,5,80.0,1,3,1,2,6,13,23,1,2459,DF,3.9,0,0,0,3,0,0,6,3,0,0,20,14,12,53.8
2460,DF,0.7,0,0,0,0,0,0,0,,0,0,0,0,0,0,0,0,2460,DF,0.7,0,0,0,0,0,4,0,0,0,0,3,0,1,0.0
2461,DF,3.9,10,6,5,3,2,5,8,62.5,3,6,0,6,7,17,11,0,2461,DF,3.9,0,0,0,5,0,3,7,6,0,0,35,4,7,36.4
2462,DF,0.3,0,0,0,0,0,0,0,,0,0,0,0,0,0,1,0,2462,DF,0.3,0,0,0,1,0,2,0,0,0,0,1,0,0,
2464,MF,0.1,0,0,0,0,0,0,0,,0,0,0,0,0,0,0,0,2464,MF,0.1,0,0,0,0,0,1,0,0,0,0,0,0,0,
2465,"MF,DF",1.2,2,1,0,2,0,1,3,33.3,2,6,0,6,1,3,3,0,2465,"MF,DF",1.2,1,0,0,2,1,5,1,1,0,0,7,0,1,0.0
2467,"DF,MF",0.3,0,0,0,0,0,0,0,,0,0,0,0,1,1,2,0,2467,"DF,MF",0.3,0,0,0,2,0,0,1,0,0,0,2,2,0,100.0
2470,"MF,DF",12.1,15,10,9,2,4,6,21,28.6,15,10,3,7,5,20,11,1,2470,"MF,DF",12.1,1,0,0,11,1,23,5,10,0,0,55,6,6,50.0
2471,MF,4.3,10,8,4,5,1,4,12,33.3,8,8,3,5,8,18,7,1,2471,MF,4.3,0,0,0,10,0,0,8,8,0,0,22,6,12,33.3
2475,DF,2.0,2,2,1,1,0,2,6,33.3,4,2,0,2,0,2,3,1,2475,DF,2.0,0,0,0,4,0,3,0,2,0,0,14,0,1,0.0
2477,MF,0.1,0,0,0,0,0,0,0,,0,0,0,0,0,0,0,0,2477,MF,0.1,0,0,0,0,0,0,0,0,0,0,0,0,1,0.0
2480,MF,8.0,19,17,3,13,3,8,20,40.0,12,7,1,6,2,21,5,0,2480,MF,8.0,1,0,0,16,0,29,2,17,0,0,52,2,7,22.2
2483,MF,31.9,53,35,24,26,3,21,47,44.7,26,55,28,27,37,90,109,0,2483,MF,31.9,7,0,0,41,10,6,37,35,1,0,151,108,78,58.1
2485,MF,25.4,39,28,24,14,1,14,26,53.8,12,25,7,18,26,65,20,1,2485,MF,25.4,10,0,0,33,0,3,26,28,0,0,148,20,11,64.5
2487,MF,29.6,125,76,59,51,15,41,74,55.4,33,57,17,40,32,157,75,1,2487,MF,29.6,3,0,0,48,2,10,32,76,1,0,153,64,38,62.7
2488,MF,16.2,28,21,15,8,5,9,25,36.0,16,20,3,17,17,45,8,1,2488,MF,16.2,6,0,0,27,2,5,17,21,0,0,73,14,18,43.8
2489,DF,8.0,20,12,17,3,0,9,13,69.2,4,7,4,3,12,32,36,3,2489,DF,8.0,2,0,0,8,0,0,12,12,0,0,39,14,8,63.6
2490,DF,1.3,1,1,1,0,0,0,0,,0,1,0,1,1,2,7,0,2490,DF,1.3,0,1,0,3,1,0,1,1,1,0,9,1,0,100.0
2491,DF,9.5,16,10,12,4,0,8,10,80.0,2,20,5,15,8,24,28,0,2491,DF,9.5,1,0,0,7,1,12,8,10,0,0,46,12,14,46.2
2492,MF,16.8,53,40,26,20,7,29,52,55.8,23,22,5,17,26,79,32,0,2492,MF,16.8,5,0,0,40,0,11,26,40,0,0,150,15,9,62.5
2493,MF,1.3,1,0,0,1,0,1,1,100.0,0,2,1,1,2,3,1,0,2493,MF,1.3,2,0,0,5,0,1,2,0,0,0,5,0,0,
2494,DF,14.6,15,7,10,5,0,8,18,44.4,10,8,2,6,3,18,15,0,2494,DF,14.6,0,0,0,8,1,84,3,7,0,0,74,6,6,50.0
2496,MF,25.8,73,42,40,27,6,33,63,52.4,30,38,12,26,72,145,67,1,2496,MF,25.8,4,0,0,30,0,54,72,42,0,0,209,52,27,65.8
2497,MF,1.9,3,0,2,0,1,2,4,50.0,2,5,0,5,2,5,5,0,2497,MF,1.9,0,0,0,2,0,2,2,0,0,0,13,12,9,57.1
2498,MF,25.9,52,22,21,23,8,18,50,36.0,32,42,23,19,23,75,55,0,2498,MF,25.9,5,1,0,49,2,10,23,22,0,0,165,63,34,64.9
2499,MF,3.2,9,7,3,5,1,6,11,54.5,5,3,1,2,2,11,8,0,2499,MF,3.2,4,0,0,7,0,2,2,7,0,0,14,8,4,66.7
2500,DF,14.0,38,20,19,13,6,22,33,66.7,11,18,3,15,9,47,26,0,2500,DF,14.0,3,0,0,5,1,16,9,20,0,0,87,12,14,46.2
2501,DF,24.6,36,30,30,5,1,19,28,67.9,9,35,28,7,34,70,159,2,2501,DF,24.6,4,0,0,15,0,1,34,30,1,0,129,72,35,67.3
2502,DF,12.1,26,15,13,11,2,12,18,66.7,6,14,7,7,19,45,61,1,2502,DF,12.1,4,0,0,20,1,0,19,15,1,0,54,29,23,55.8
2504,DF,11.8,18,8,7,9,2,10,30,33.3,20,22,8,14,15,33,26,0,2504,DF,11.8,3,1,1,16,0,26,15,8,0,0,49,9,17,34.6
2505,DF,6.6,15,8,7,7,1,9,13,69.2,4,8,1,7,5,20,13,0,2505,DF,6.6,0,0,0,5,0,12,5,8,0,0,27,4,9,30.8
2508,MF,0.9,0,0,0,0,0,0,1,0.0,1,2,0,2,0,0,3,0,2508,MF,0.9,0,0,0,0,0,3,0,0,0,0,1,2,0,100.0
2509,MF,29.9,55,33,15,34,6,24,42,57.1,18,41,13,28,28,83,25,2,2509,MF,29.9,5,0,0,36,0,81,28,33,0,0,196,30,30,50.0
2510,MF,29.6,49,30,21,21,7,25,63,39.7,38,46,4,42,19,68,18,0,2510,MF,29.6,8,0,0,36,1,258,19,30,0,0,210,8,33,19.5
2512,"DF,MF",11.8,2,1,1,0,1,0,3,0.0,3,11,7,4,10,12,21,0,2512,"DF,MF",11.8,2,0,0,4,0,5,10,1,0,0,46,14,5,73.7
2516,MF,13.4,34,19,13,18,3,15,31,48.4,16,20,6,14,7,41,22,0,2516,MF,13.4,4,0,0,16,0,20,7,19,0,0,73,7,11,38.9
2518,DF,28.5,53,36,33,15,5,31,37,83.8,6,33,14,19,18,71,84,0,2518,DF,28.5,7,0,0,27,3,15,18,36,1,1,98,47,47,50.0
2519,DF,14.4,36,21,16,16,4,26,45,57.8,19,13,3,10,10,46,31,0,2519,DF,14.4,7,1,0,24,0,49,10,21,1,0,77,9,9,50.0
2521,DF,26.2,66,32,40,19,7,38,86,44.2,48,37,4,33,26,92,33,0,2521,DF,26.2,5,0,0,24,3,101,26,32,0,0,143,17,20,45.9
2523,DF,16.8,18,10,14,3,1,11,16,68.8,5,25,14,11,25,43,58,2,2523,DF,16.8,0,0,0,9,0,2,25,10,0,0,83,22,14,61.1
2524,MF,14.9,36,14,15,15,6,17,27,63.0,10,24,5,19,7,43,23,0,2524,MF,14.9,4,0,0,18,1,13,7,14,0,0,85,13,19,40.6
2527,MF,19.1,37,17,8,19,10,12,38,31.6,26,25,5,20,21,58,28,0,2527,MF,19.1,8,0,0,42,2,55,21,17,0,0,98,20,11,64.5
2532,DF,19.9,54,23,30,19,5,29,40,72.5,11,40,11,29,26,80,70,2,2532,DF,19.9,4,0,0,30,1,3,26,23,0,1,124,32,21,60.4
2533,DF,0.5,1,1,0,1,0,0,0,,0,0,0,0,1,2,2,0,2533,DF,0.5,0,0,0,0,0,4,1,1,0,0,0,0,0,
2536,DF,3.2,3,1,3,0,0,1,4,25.0,3,6,2,4,1,4,7,0,2536,DF,3.2,1,0,0,7,0,5,1,1,0,1,11,5,5,50.0
2537,DF,1.1,1,1,1,0,0,1,2,50.0,1,5,2,3,1,2,11,1,2537,DF,1.1,0,0,0,0,1,0,1,1,0,0,4,2,2,50.0
2539,MF,23.4,32,19,12,12,8,16,50,32.0,34,37,2,35,15,47,16,1,2539,MF,23.4,1,0,0,29,3,113,15,19,0,0,171,12,20,37.5
2540,MF,0.1,0,0,0,0,0,0,0,,0,1,1,0,0,0,0,0,2540,MF,0.1,0,0,0,0,0,0,0,0,0,0,1,0,0,
2543,DF,23.6,54,34,23,22,9,22,49,44.9,27,25,8,17,28,82,43,0,2543,DF,23.6,7,1,1,37,0,40,28,34,0,0,76,20,15,57.1
2544,DF,29.2,19,9,10,7,2,5,16,31.3,11,28,23,5,23,42,97,1,2544,DF,29.2,6,0,0,33,1,3,23,9,0,0,161,62,22,73.8
2545,DF,24.5,38,22,23,13,2,19,32,59.4,13,39,23,16,32,70,114,0,2545,DF,24.5,2,0,0,18,1,3,32,22,0,0,116,51,37,58.0
2547,"DF,MF",23.8,35,16,13,18,4,18,37,48.6,19,24,11,13,47,82,25,2,2547,"DF,MF",23.8,6,1,0,19,0,15,47,16,1,0,140,30,39,43.5
2548,"MF,DF",14.9,41,29,19,19,3,14,25,56.0,11,31,7,24,21,62,50,1,2548,"MF,DF",14.9,5,1,1,24,1,9,21,29,0,0,112,43,33,56.6
2549,DF,23.2,34,25,17,15,2,17,24,70.8,7,21,10,11,24,58,52,3,2549,DF,23.2,4,0,0,25,1,5,24,25,0,0,175,40,38,51.3
2550,DF,0.9,2,0,1,1,0,1,1,100.0,0,1,0,1,0,2,2,0,2550,DF,0.9,1,0,0,0,0,0,0,0,0,0,5,0,3,0.0
2551,MF,11.4,23,11,16,7,0,15,25,60.0,10,9,3,6,20,43,14,2,2551,MF,11.4,4,1,1,13,0,8,20,11,0,0,68,7,13,35.0
2552,DF,38.0,61,42,46,14,1,27,48,56.3,21,82,56,26,56,117,191,2,2552,DF,38.0,11,0,0,45,1,6,56,42,1,0,186,140,61,69.7
2553,DF,0.1,0,0,0,0,0,0,0,,0,0,0,0,0,0,2,0,2553,DF,0.1,0,0,0,0,0,0,0,0,0,0,0,0,0,
2555,DF,5.1,11,7,9,1,1,8,9,88.9,1,6,0,6,1,12,21,0,2555,DF,5.1,2,0,0,8,0,16,1,7,0,0,33,3,2,60.0
2558,DF,25.9,35,20,19,14,2,17,35,48.6,18,27,11,16,19,54,78,0,2558,DF,25.9,8,0,0,20,2,71,19,20,0,0,106,41,38,51.9
2561,DF,19.2,39,26,25,12,2,23,48,47.9,25,17,7,10,23,62,49,2,2561,DF,19.2,2,0,0,18,2,64,23,26,1,0,84,13,13,50.0
2562,DF,12.5,26,17,18,4,4,11,25,44.0,14,20,7,13,11,37,25,0,2562,DF,12.5,2,0,0,15,0,49,11,17,0,0,42,10,11,47.6
2563,"MF,DF",22.1,38,23,19,17,2,9,18,50.0,9,21,13,8,28,66,52,1,2563,"MF,DF",22.1,7,0,0,20,0,22,28,23,0,0,99,51,24,68.0
2565,"DF,MF",9.1,13,8,6,5,2,5,10,50.0,5,10,0,10,3,16,8,0,2565,"DF,MF",9.1,2,0,0,11,4,27,3,8,0,0,30,5,9,35.7
2566,DF,12.7,29,19,22,4,3,16,28,57.1,12,14,8,6,12,41,59,0,2566,DF,12.7,5,0,0,13,2,17,12,19,0,0,47,25,18,58.1
2569,DF,14.4,30,19,23,6,1,17,31,54.8,14,24,6,18,20,50,17,0,2569,DF,14.4,1,0,0,15,0,59,20,19,0,0,74,19,18,51.4
2572,"MF,DF",8.7,17,13,8,8,1,7,15,46.7,8,11,1,10,3,20,9,0,2572,"MF,DF",8.7,4,0,0,15,1,28,3,13,1,0,45,5,5,50.0
2574,DF,9.6,27,17,19,6,2,11,19,57.9,8,10,3,7,16,43,35,0,2574,DF,9.6,2,0,0,16,0,23,16,17,1,0,45,5,5,50.0
2576,MF,23.5,54,36,19,21,14,25,62,40.3,37,33,4,29,20,74,6,0,2576,MF,23.5,7,0,0,32,1,139,20,36,0,0,146,10,15,40.0
2578,DF,25.5,30,17,19,6,5,24,37,64.9,13,40,23,17,31,61,90,2,2578,DF,25.5,4,0,0,16,0,11,31,17,0,0,134,41,22,65.1
2579,"MF,DF",14.0,24,16,13,7,4,13,22,59.1,9,16,6,10,14,38,21,0,2579,"MF,DF",14.0,3,0,0,13,0,22,14,16,1,0,77,12,10,54.5
2580,DF,18.0,34,17,15,17,2,12,25,48.0,13,23,13,10,13,47,55,0,2580,DF,18.0,5,1,0,31,0,0,13,17,1,1,76,37,21,63.8
2583,DF,10.2,20,9,13,6,1,8,14,57.1,6,23,5,18,10,30,27,0,2583,DF,10.2,3,0,0,10,0,13,10,9,0,0,39,10,15,40.0
2584,MF,13.3,25,14,4,16,5,11,34,32.4,23,14,0,14,9,34,10,1,2584,MF,13.3,2,1,0,16,5,47,9,14,0,0,89,13,23,36.1
2585,MF,12.9,19,11,9,8,2,7,14,50.0,7,21,5,16,4,23,20,0,2585,MF,12.9,2,0,0,28,6,9,4,11,0,0,41,67,56,54.5
2586,MF,26.6,40,22,7,28,5,22,44,50.0,22,25,9,16,21,61,36,0,2586,MF,26.6,7,0,0,36,1,26,21,22,0,0,112,55,68,44.7
2587,MF,23.4,42,29,13,23,6,20,40,50.0,20,21,10,11,18,60,37,0,2587,MF,23.4,7,0,0,33,2,20,18,29,0,0,129,19,17,52.8
2591,DF,13.8,37,24,16,18,3,18,27,66.7,9,22,8,14,10,47,45,0,2591,DF,13.8,1,0,0,6,0,26,10,24,0,0,52,16,20,44.4
2594,DF,0.0,0,0,0,0,0,0,0,,0,0,0,0,0,0,0,0,2594,DF,0.0,0,0,0,0,0,0,0,0,0,0,0,0,0,
2595,DF,0.8,2,2,1,1,0,0,0,,0,1,0,1,0,2,1,0,2595,DF,0.8,2,0,0,3,1,1,0,2,0,0,4,1,1,50.0
2596,DF,29.5,58,28,35,17,6,34,56,60.7,22,34,15,19,38,96,97,1,2596,DF,29.5,2,1,0,25,0,12,38,28,0,1,212,39,26,60.0
2597,DF,16.2,26,14,20,6,0,15,24,62.5,9,34,13,21,14,40,49,0,2597,DF,16.2,3,0,0,17,0,47,14,14,0,0,57,25,15,62.5
2598,MF,11.2,16,12,9,7,0,6,19,31.6,13,11,1,10,6,22,12,0,2598,MF,11.2,5,0,0,10,0,6,6,12,0,0,62,2,10,16.7
2599,MF,19.3,33,21,13,11,9,14,33,42.4,19,26,9,17,10,43,18,0,2599,MF,19.3,5,0,0,24,1,36,10,21,1,0,117,37,22,62.7
2600,DF,23.1,13,10,8,4,1,9,15,60.0,6,17,5,12,16,29,49,1,2600,DF,23.1,1,0,0,10,0,50,16,10,1,0,103,9,16,36.0
2601,DF,10.7,20,9,7,8,5,14,27,51.9,13,9,4,5,13,33,29,0,2601,DF,10.7,6,1,1,17,0,8,13,9,0,0,58,17,14,54.8
2604,DF,12.8,20,9,15,4,1,11,18,61.1,7,10,4,6,18,38,33,0,2604,DF,12.8,2,1,1,14,1,14,18,9,0,0,54,25,20,55.6
2605,DF,0.1,0,0,0,0,0,0,0,,0,0,0,0,1,1,0,0,2605,DF,0.1,0,0,0,0,0,0,1,0,0,0,2,2,0,100.0
2606,DF,23.6,42,24,29,10,3,18,29,62.1,11,34,23,11,26,68,75,1,2606,DF,23.6,8,1,1,26,1,3,26,24,1,0,105,29,26,52.7
2607,MF,4.9,7,7,4,2,1,3,9,33.3,6,3,0,3,2,9,4,0,2607,MF,4.9,2,0,0,9,0,11,2,7,0,0,20,1,0,100.0
2610,DF,13.9,29,16,20,9,0,17,22,77.3,5,16,10,6,11,40,68,2,2610,DF,13.9,4,0,0,18,1,2,11,16,1,1,56,22,15,59.5
2612,MF,18.0,37,22,17,15,5,22,57,38.6,35,40,4,36,6,43,6,0,2612,MF,18.0,3,0,0,26,6,44,6,22,0,0,127,11,28,28.2
2613,DF,27.4,29,18,17,11,1,14,30,46.7,16,28,12,16,14,43,75,0,2613,DF,27.4,1,0,0,18,2,8,14,18,0,0,127,23,22,51.1
2614,MF,19.9,25,15,11,8,6,11,28,39.3,17,10,2,8,33,58,37,0,2614,MF,19.9,5,0,0,43,0,3,33,15,0,0,115,71,41,63.4
2616,DF,3.1,6,4,3,3,0,3,4,75.0,1,4,3,1,7,13,20,0,2616,DF,3.1,1,0,0,6,0,0,7,4,0,0,16,5,6,45.5
2617,MF,25.4,47,28,22,22,3,30,60,50.0,30,30,8,22,25,72,33,0,2617,MF,25.4,4,0,0,27,0,4,25,28,0,0,173,42,40,51.2
2618,DF,22.8,25,12,16,9,0,8,14,57.1,6,38,20,18,36,61,101,2,2618,DF,22.8,6,0,0,36,0,5,36,12,1,0,87,43,16,72.9
2619,MF,17.5,35,20,14,17,4,17,37,45.9,20,32,9,23,25,60,41,0,2619,MF,17.5,5,0,0,31,0,9,25,20,0,0,93,38,38,50.0
2626,MF,6.3,5,4,2,1,2,1,4,25.0,3,6,0,6,1,6,2,0,2626,MF,6.3,4,0,0,7,2,9,1,4,0,0,22,4,3,57.1
2627,MF,9.1,35,23,16,17,2,9,21,42.9,12,12,2,10,5,40,7,0,2627,MF,9.1,4,0,0,23,1,6,5,23,0,0,62,6,16,27.3
2629,MF,0.2,0,0,0,0,0,0,0,,0,0,0,0,0,0,0,0,2629,MF,0.2,0,0,0,0,1,0,0,0,0,0,0,0,0,
2630,DF,25.5,44,19,24,17,3,25,43,58.1,18,27,8,19,24,68,59,2,2630,DF,25.5,7,0,0,32,1,47,24,19,1,0,136,29,35,45.3
2631,DF,24.7,19,12,13,6,0,8,21,38.1,13,33,20,13,30,49,86,0,2631,DF,24.7,2,0,0,23,0,0,30,12,1,0,108,23,33,41.1
2632,DF,27.5,60,33,33,21,6,32,56,57.1,24,32,7,25,40,100,54,1,2632,DF,27.5,5,0,0,30,1,73,40,33,1,0,155,15,19,44.1
2637,MF,3.4,7,5,6,1,0,4,10,40.0,6,1,1,0,3,10,9,0,2637,MF,3.4,0,0,0,5,1,5,3,5,0,0,15,4,1,80.0
2638,DF,18.3,23,15,12,10,1,13,33,39.4,20,16,3,13,13,36,57,0,2638,DF,18.3,2,1,0,13,3,165,13,15,1,0,78,26,20,56.5
2639,DF,24.8,57,27,30,16,11,37,77,48.1,40,41,8,33,24,81,57,3,2639,DF,24.8,5,0,0,27,3,212,24,27,0,0,162,31,17,64.6
2641,DF,23.8,39,21,23,10,6,25,40,62.5,15,31,5,26,19,58,49,0,2641,DF,23.8,6,0,0,25,4,72,19,21,0,0,116,18,24,42.9
2642,DF,28.6,47,30,31,13,3,21,43,48.8,22,41,22,19,35,82,153,3,2642,DF,28.6,4,0,0,23,3,5,35,30,1,0,89,61,50,55.0
2643,DF,7.5,19,13,9,6,4,9,15,60.0,6,9,1,8,6,25,10,0,2643,DF,7.5,0,0,0,11,1,72,6,13,0,0,43,3,13,18.8
2647,MF,18.7,31,17,6,20,5,13,30,43.3,17,19,8,11,6,37,17,0,2647,MF,18.7,4,0,0,36,0,19,6,17,0,0,81,16,31,34.0
2648,DF,28.9,63,33,38,19,6,39,59,66.1,20,29,12,17,36,99,99,0,2648,DF,28.9,3,2,1,29,0,11,36,33,0,0,171,52,43,54.7
2649,DF,26.6,68,33,41,16,11,27,49,55.1,22,27,8,19,37,105,80,5,2649,DF,26.6,7,1,1,51,3,22,37,33,0,0,169,22,26,45.8
2650,DF,30.0,55,37,38,12,5,38,56,67.9,18,62,16,46,50,105,108,0,2650,DF,30.0,5,0,0,28,1,73,50,37,0,0,149,27,40,40.3
2651,MF,21.5,98,57,39,43,16,43,89,48.3,46,27,6,21,40,138,25,2,2651,MF,21.5,5,0,0,46,0,4,40,57,0,0,181,14,12,53.8
2652,MF,3.3,14,10,4,8,2,4,10,40.0,6,6,2,4,1,15,5,0,2652,MF,3.3,2,0,0,4,0,0,1,10,0,0,12,9,2,81.8
2655,DF,2.1,1,1,0,1,0,1,4,25.0,3,0,0,0,2,3,4,0,2655,DF,2.1,0,0,0,3,0,0,2,1,0,0,9,1,1,50.0
2659,DF,19.6,34,21,21,11,2,15,29,51.7,14,19,7,12,19,53,56,3,2659,DF,19.6,3,1,1,22,2,3,19,21,1,0,156,42,25,62.7
2663,DF,13.1,28,18,15,11,2,15,30,50.0,15,11,5,6,2,30,16,1,2663,DF,13.1,2,0,0,11,2,22,2,18,0,0,58,8,15,34.8
2664,MF,29.9,107,66,39,62,6,46,101,45.5,55,62,10,52,35,142,52,1,2664,MF,29.9,7,1,1,77,0,5,35,66,0,0,160,33,50,39.8
2665,DF,13.1,19,16,10,5,4,10,21,47.6,11,14,3,11,9,28,22,0,2665,DF,13.1,3,0,0,12,0,73,9,16,0,0,62,9,9,50.0
2666,DF,26.1,34,18,19,13,2,18,30,60.0,12,26,11,15,29,63,112,1,2666,DF,26.1,5,0,0,29,2,18,29,18,0,0,97,46,24,65.7
2667,DF,1.2,3,1,1,2,0,2,2,100.0,0,3,2,1,0,3,1,1,2667,DF,1.2,1,0,0,2,0,0,0,1,0,0,8,0,1,0.0
2669,MF,32.3,47,34,22,13,12,24,42,57.1,18,39,2,37,43,90,40,0,2669,MF,32.3,2,0,0,19,0,30,43,34,0,0,160,21,10,67.7
2671,DF,3.2,9,2,7,2,0,4,6,66.7,2,1,1,0,7,16,12,0,2671,DF,3.2,2,1,0,8,1,0,7,2,0,0,10,8,6,57.1
2672,DF,35.3,40,23,24,13,3,12,14,85.7,2,47,34,13,39,79,144,0,2672,DF,35.3,3,1,0,23,1,0,39,23,0,0,170,140,32,81.4
2673,DF,18.2,60,41,20,30,10,32,70,45.7,38,29,2,27,35,95,37,1,2673,DF,18.2,6,1,1,45,1,48,35,41,0,0,126,12,25,32.4
2674,DF,15.3,18,11,10,7,1,10,14,71.4,4,23,18,5,15,33,88,0,2674,DF,15.3,2,0,0,8,2,0,15,11,0,0,67,21,5,80.8
2676,DF,31.7,51,33,38,11,2,32,50,64.0,18,50,26,24,45,96,113,0,2676,DF,31.7,6,0,0,36,4,30,45,33,1,0,101,77,55,58.3
2677,MF,36.7,78,53,36,36,6,37,71,52.1,34,41,10,31,49,127,71,0,2677,MF,36.7,4,0,0,51,1,147,49,53,1,0,244,57,42,57.6
2679,"DF,MF",8.0,24,12,13,8,3,10,16,62.5,6,17,4,13,3,27,24,0,2679,"DF,MF",8.0,1,0,0,8,1,18,3,12,0,0,47,12,19,38.7
2680,DF,7.8,15,13,7,7,1,12,21,57.1,9,11,3,8,5,20,25,0,2680,DF,7.8,3,0,0,11,0,8,5,13,1,0,29,10,8,55.6
2681,DF,15.8,37,25,22,14,1,18,25,72.0,7,27,5,22,12,49,36,0,2681,DF,15.8,0,0,0,22,5,47,12,25,0,0,78,4,6,40.0
2682,MF,12.8,32,17,12,20,0,20,31,64.5,11,17,5,12,12,44,21,0,2682,MF,12.8,8,0,0,32,2,5,12,17,0,0,66,34,36,48.6
2686,DF,21.3,31,15,17,13,1,16,31,51.6,15,31,20,11,17,48,57,0,2686,DF,21.3,2,0,0,9,0,20,17,15,0,0,95,38,44,46.3
2687,DF,17.6,54,41,32,17,5,39,58,67.2,19,17,7,10,18,72,57,1,2687,DF,17.6,4,0,0,17,1,11,18,41,0,0,76,28,21,57.1
2688,DF,26.0,49,35,34,12,3,24,33,72.7,9,25,15,10,18,67,78,1,2688,DF,26.0,5,0,0,13,1,3,18,35,1,0,144,38,41,48.1
2689,DF,4.0,6,4,5,1,0,6,10,60.0,4,4,3,1,5,11,14,0,2689,DF,4.0,1,0,0,5,0,10,5,4,1,0,21,2,3,40.0
2692,MF,24.3,38,22,19,13,6,18,39,46.2,21,20,4,16,13,51,25,0,2692,MF,24.3,4,0,0,22,1,114,13,22,0,0,151,9,19,32.1
2693,MF,1.8,1,0,0,1,0,0,1,0.0,1,5,0,5,6,7,2,0,2693,MF,1.8,2,0,0,7,0,0,6,0,0,0,14,1,6,14.3
2695,MF,17.0,40,20,11,23,6,19,49,38.8,30,19,7,12,32,72,35,1,2695,MF,17.0,2,0,0,28,0,13,32,20,0,0,112,31,31,50.0
2699,DF,4.6,12,5,4,5,3,6,13,46.2,7,5,2,3,3,15,9,0,2699,DF,4.6,2,0,0,9,0,15,3,5,0,0,18,13,7,65.0
2703,MF,10.1,19,9,6,9,4,10,19,52.6,9,4,0,4,4,23,1,0,2703,MF,10.1,3,1,1,10,4,6,4,9,0,0,36,3,6,33.3
2709,MF,20.0,51,33,26,20,5,26,41,63.4,15,32,10,22,6,57,26,1,2709,MF,20.0,7,0,0,44,2,24,6,33,0,0,131,31,17,64.6
2711,DF,11.3,34,21,22,7,5,20,36,55.6,16,12,2,10,9,43,34,0,2711,DF,11.3,1,0,0,12,0,29,9,21,0,2,45,11,15,42.3
2717,DF,1.8,2,2,1,1,0,2,2,100.0,0,2,2,0,2,4,9,1,2717,DF,1.8,0,0,0,3,0,0,2,2,0,0,3,2,5,28.6
2718,DF,10.9,24,15,14,7,3,10,22,45.5,12,20,10,10,10,34,44,0,2718,DF,10.9,0,0,0,9,0,1,10,15,1,1,45,13,10,56.5
2721,MF,23.6,39,24,12,16,11,16,48,33.3,32,29,11,18,23,62,30,2,2721,MF,23.6,0,0,0,17,1,38,23,24,0,0,154,4,10,28.6
2722,"DF,MF",25.7,64,34,36,22,6,43,86,50.0,43,44,6,38,12,76,47,4,2722,"DF,MF",25.7,1,0,0,27,6,56,12,34,2,0,109,19,22,46.3
2723,DF,32.0,42,28,29,11,2,28,45,62.2,17,49,25,24,31,73,104,0,2723,DF,32.0,6,0,0,37,1,4,31,28,0,0,213,34,46,42.5
2727,DF,13.0,23,15,14,8,1,12,15,80.0,3,16,10,6,30,53,40,1,2727,DF,13.0,4,0,0,13,1,12,30,15,0,0,52,25,21,54.3
2728,DF,14.7,14,10,7,7,0,8,13,61.5,5,16,13,3,9,23,54,0,2728,DF,14.7,2,0,0,11,0,3,9,10,0,0,99,7,5,58.3
2729,DF,14.7,10,9,6,4,0,6,12,50.0,6,22,15,7,7,17,72,2,2729,DF,14.7,5,0,0,17,1,0,7,9,0,0,74,15,11,57.7
2730,DF,15.3,17,8,7,6,4,11,16,68.8,5,12,2,10,13,30,28,0,2730,DF,15.3,3,0,0,12,4,64,13,8,0,0,65,5,10,33.3
2733,MF,12.8,32,15,11,11,10,15,28,53.6,13,17,6,11,14,46,29,0,2733,MF,12.8,6,0,0,29,0,10,14,15,0,0,72,15,6,71.4
2734,DF,17.6,18,13,13,4,1,8,15,53.3,7,22,10,12,24,42,51,0,2734,DF,17.6,0,0,0,8,0,0,24,13,0,0,85,46,25,64.8
2737,MF,36.0,66,43,40,26,0,36,77,46.8,41,43,6,37,43,109,66,1,2737,MF,36.0,7,0,0,42,0,12,43,43,0,0,276,29,19,60.4
2739,DF,30.7,38,24,19,17,2,19,39,48.7,20,19,6,13,27,65,40,1,2739,DF,30.7,2,0,0,23,7,59,27,24,0,0,152,25,15,62.5
2740,DF,22.8,39,28,33,6,0,28,41,68.3,13,50,31,19,15,54,121,0,2740,DF,22.8,6,0,0,23,2,1,15,28,2,0,85,39,49,44.3
2741,DF,19.8,42,25,18,20,4,19,26,73.1,7,29,15,14,41,83,68,1,2741,DF,19.8,4,0,0,17,0,14,41,25,1,0,94,21,19,52.5
2742,DF,22.0,45,28,26,18,1,30,47,63.8,17,17,10,7,14,59,94,1,2742,DF,22.0,4,0,0,22,0,22,14,28,0,1,94,46,48,48.9
2743,MF,33.3,45,29,14,23,8,18,44,40.9,26,31,9,22,38,83,49,0,2743,MF,33.3,4,0,0,24,0,189,38,29,0,0,145,26,33,44.1
2749,DF,12.7,14,12,8,5,1,6,18,33.3,12,16,12,4,16,30,43,1,2749,DF,12.7,2,0,0,9,0,1,16,12,0,1,63,33,13,71.7
2751,MF,30.7,66,40,28,32,6,41,67,61.2,26,47,14,33,48,114,61,1,2751,MF,30.7,10,0,0,33,0,3,48,40,0,0,168,25,19,56.8
2753,"DF,MF",29.3,64,38,29,25,10,31,53,58.5,22,36,6,30,20,84,43,0,2753,"DF,MF",29.3,5,0,0,29,4,82,20,38,0,0,171,23,40,36.5
2760,MF,14.4,48,32,18,22,8,23,46,50.0,23,17,3,14,20,68,24,1,2760,MF,14.4,2,0,0,18,0,25,20,32,0,0,76,7,12,36.8
2762,DF,33.2,48,28,20,22,6,26,58,44.8,32,48,22,26,32,80,77,1,2762,DF,33.2,8,0,0,19,11,57,32,28,0,0,120,36,22,62.1
2763,MF,0.1,1,1,1,0,0,0,0,,0,0,0,0,0,1,0,0,2763,MF,0.1,1,0,0,2,0,0,0,1,0,0,2,0,2,0.0
2764,DF,13.8,23,10,12,8,3,17,28,60.7,11,18,5,13,16,39,37,0,2764,DF,13.8,4,0,0,10,3,35,16,10,0,0,61,19,32,37.3
2765,DF,10.7,14,11,9,3,2,3,10,30.0,7,10,5,5,14,28,48,0,2765,DF,10.7,5,1,1,12,0,4,14,11,0,0,47,27,18,60.0
2766,DF,1.9,4,1,3,1,0,3,5,60.0,2,4,2,2,5,9,8,0,2766,DF,1.9,0,0,0,0,1,0,5,1,0,0,12,4,2,66.7
2768,DF,18.2,69,40,42,18,9,35,56,62.5,21,44,13,31,22,91,53,0,2768,DF,18.2,4,0,0,23,4,68,22,40,0,0,107,31,20,60.8
2771,MF,4.7,13,7,7,6,0,4,11,36.4,7,7,0,7,1,14,1,0,2771,MF,4.7,0,0,0,3,1,6,1,7,0,0,26,1,1,50.0
2774,"DF,MF",5.1,5,4,2,3,0,2,8,25.0,6,5,2,3,6,11,7,0,2774,"DF,MF",5.1,1,0,0,6,1,12,6,4,0,0,27,4,3,57.1
2777,MF,26.4,27,18,7,14,6,9,29,31.0,20,36,2,34,9,36,3,0,2777,MF,26.4,3,0,0,23,6,36,9,18,0,0,143,9,15,37.5
2779,DF,30.9,35,21,23,12,0,17,24,70.8,7,40,21,19,16,51,119,0,2779,DF,30.9,5,0,0,24,0,4,16,21,0,0,148,55,26,67.9
2781,DF,23.0,66,31,40,25,1,31,53,58.5,22,47,26,21,38,104,111,0,2781,DF,23.0,4,1,1,27,5,21,38,31,0,0,147,47,32,59.5
2782,DF,13.0,20,12,8,11,1,11,23,47.8,12,12,2,10,8,28,20,0,2782,DF,13.0,2,0,0,12,1,45,8,12,1,0,79,6,8,42.9
2787,DF,15.4,18,12,12,6,0,8,15,53.3,7,19,9,10,18,36,51,0,2787,DF,15.4,3,1,0,19,0,2,18,12,1,0,71,35,19,64.8
2788,DF,4.9,7,5,6,1,0,3,6,50.0,3,5,4,1,3,10,32,1,2788,DF,4.9,0,1,0,3,0,0,3,5,0,0,18,12,10,54.5
2790,MF,31.3,29,21,11,14,4,9,30,30.0,21,29,8,21,19,48,42,0,2790,MF,31.3,5,0,0,30,0,10,19,21,0,0,226,26,22,54.2
2791,DF,0.7,2,1,1,1,0,1,1,100.0,0,0,0,0,3,5,3,0,2791,DF,0.7,0,0,0,1,0,0,3,1,0,0,3,2,1,66.7
2794,MF,7.6,17,11,6,8,3,7,17,41.2,10,17,4,13,6,23,5,0,2794,MF,7.6,2,0,0,12,1,14,6,11,0,0,50,9,10,47.4
2795,MF,22.1,66,40,39,21,6,20,36,55.6,16,42,15,27,21,87,44,1,2795,MF,22.1,6,0,0,54,2,6,21,40,0,0,110,41,36,53.2
2800,DF,12.9,30,23,17,11,2,14,25,56.0,11,14,2,12,15,45,36,0,2800,DF,12.9,3,0,0,21,3,76,15,23,1,0,88,11,11,50.0
2801,DF,29.7,36,25,27,7,2,17,31,54.8,14,20,14,6,36,72,97,1,2801,DF,29.7,5,0,0,20,0,1,36,25,1,1,124,44,25,63.8
2802,"DF,MF",25.3,53,38,28,19,6,30,54,55.6,24,24,6,18,22,75,50,3,2802,"DF,MF",25.3,7,1,1,33,1,100,22,38,1,1,120,19,32,37.3
2803,DF,21.6,15,9,13,2,0,7,11,63.6,4,21,16,5,44,59,104,0,2803,DF,21.6,1,0,0,11,2,0,44,9,0,0,76,30,12,71.4
2804,DF,37.0,59,32,29,29,1,23,50,46.0,27,53,34,19,33,92,143,4,2804,DF,37.0,5,0,0,24,0,1,33,32,0,0,153,75,60,55.6
2806,DF,16.1,21,14,16,5,0,4,8,50.0,4,23,18,5,20,41,78,1,2806,DF,16.1,1,0,0,17,1,0,20,14,0,1,109,60,13,82.2
2807,DF,4.1,18,8,11,4,3,11,24,45.8,13,3,0,3,4,22,9,1,2807,DF,4.1,1,0,0,5,0,2,4,8,0,0,25,0,8,0.0
2808,"MF,DF",21.8,51,28,18,24,9,28,51,54.9,23,32,8,24,15,66,22,2,2808,"MF,DF",21.8,4,0,0,21,1,8,15,28,1,0,112,7,19,26.9
2809,"MF,DF",23.7,38,27,11,20,7,12,30,40.0,18,39,13,26,47,85,41,0,2809,"MF,DF",23.7,13,2,2,33,0,9,47,27,1,0,165,10,14,41.7
2811,DF,7.8,20,12,17,2,1,13,21,61.9,8,6,4,2,2,22,20,0,2811,DF,7.8,3,0,0,14,2,17,2,12,0,1,24,10,5,66.7
2813,MF,31.0,61,33,21,29,11,34,69,49.3,35,40,5,35,28,89,19,1,2813,MF,31.0,2,0,0,41,3,20,28,33,0,0,174,46,45,50.5
2815,DF,10.2,16,13,9,7,0,7,12,58.3,5,10,2,8,1,17,17,0,2815,DF,10.2,3,0,0,5,1,30,1,13,0,1,26,7,12,36.8
2819,DF,28.5,54,31,29,16,9,29,41,70.7,12,29,5,24,20,74,75,2,2819,DF,28.5,2,0,0,21,0,77,20,31,0,0,109,19,32,37.3
2820,DF,20.7,30,20,15,10,5,16,34,47.1,18,29,4,25,5,35,19,0,2820,DF,20.7,5,0,0,26,2,76,5,20,0,0,99,9,13,40.9
2824,MF,4.5,3,3,2,1,0,1,5,20.0,4,5,2,3,5,8,16,1,2824,MF,4.5,0,0,0,3,0,5,5,3,0,0,12,3,3,50.0
2825,"DF,MF",13.7,31,20,17,11,3,17,34,50.0,17,14,3,11,16,47,34,0,2825,"DF,MF",13.7,2,0,0,13,2,42,16,20,0,0,64,7,13,35.0
2826,DF,11.5,24,16,13,7,4,11,19,57.9,8,5,1,4,13,37,21,0,2826,DF,11.5,1,0,0,15,0,21,13,16,0,0,41,9,10,47.4
2830,MF,0.3,1,1,1,0,0,0,0,,0,1,0,1,0,1,1,0,2830,MF,0.3,0,0,0,0,0,1,0,1,0,0,1,1,1,50.0
2831,DF,18.2,19,9,13,4,2,10,22,45.5,12,32,21,11,15,34,88,1,2831,DF,18.2,5,0,0,24,0,5,15,9,1,0,66,39,16,70.9
2833,DF,11.4,11,6,9,2,0,7,14,50.0,7,12,3,9,12,23,47,1,2833,DF,11.4,1,0,0,8,0,1,12,6,0,0,36,17,12,58.6
2835,MF,21.4,23,15,6,13,4,12,24,50.0,12,12,1,11,9,32,15,0,2835,MF,21.4,1,0,0,15,0,89,9,15,0,0,87,6,11,35.3
2836,DF,1.0,1,1,1,0,0,0,0,,0,0,0,0,3,4,7,0,2836,DF,1.0,0,0,0,0,0,0,3,1,0,0,6,2,5,28.6
2837,DF,13.6,33,21,26,7,0,19,39,48.7,20,21,14,7,21,54,66,1,2837,DF,13.6,5,0,0,13,1,0,21,21,0,1,53,29,21,58.0
2838,DF,19.1,50,30,19,24,7,35,52,67.3,17,18,3,15,20,70,26,2,2838,DF,19.1,2,0,0,7,1,30,20,30,0,0,104,27,16,62.8
2840,DF,0.1,0,0,0,0,0,0,1,0.0,1,1,1,0,1,1,0,0,2840,DF,0.1,0,0,0,0,0,0,1,0,0,0,1,0,0,
2842,DF,14.0,21,14,8,13,0,10,22,45.5,12,13,5,8,4,25,29,1,2842,DF,14.0,3,0,0,15,0,74,4,14,0,0,53,11,21,34.4
2843,DF,1.7,5,4,3,1,1,1,4,25.0,3,2,0,2,1,6,3,0,2843,DF,1.7,1,0,0,4,0,12,1,4,0,0,4,0,2,0.0
2844,DF,31.5,23,17,14,9,0,10,16,62.5,6,38,28,10,29,52,160,0,2844,DF,31.5,3,0,0,24,0,0,29,17,1,0,95,58,43,57.4
2845,DF,28.0,32,25,20,10,2,19,26,73.1,7,28,19,9,32,64,97,3,2845,DF,28.0,11,1,0,43,0,3,32,25,1,0,156,83,81,50.6
2846,MF,29.5,49,27,18,29,2,23,42,54.8,19,33,9,24,37,86,54,0,2846,MF,29.5,5,0,0,36,0,7,37,27,0,0,169,44,28,61.1
2847,MF,9.6,15,6,5,8,2,5,15,33.3,10,5,1,4,6,21,11,0,2847,MF,9.6,4,0,0,19,2,6,6,6,0,0,37,7,17,29.2
2849,MF,34.3,49,17,18,21,10,17,58,29.3,41,23,1,22,15,64,5,0,2849,MF,34.3,2,0,0,30,3,77,15,17,0,0,158,3,9,25.0
2852,MF,12.7,23,12,8,12,3,11,26,42.3,15,13,2,11,7,30,16,0,2852,MF,12.7,3,0,0,24,2,6,7,12,0,0,60,13,16,44.8
